ywrs	异位妊娠
jxpqy	急性盆腔炎
lcpl	卵巢破裂
lcnzdnz	卵巢扭转
xzlc	先兆流产
nmlc	难免流产
zrlc	自然流产
mxpqy	慢性盆腔炎
mxpqyjxfz	慢性盆腔炎急性发作
wexzl	胃恶性肿瘤
jxyxy	急性胰腺炎
wcgnwl	胃肠功能紊乱
jxcy	急性肠炎
jxwy	急性胃炎
jxwcy	急性胃肠炎
mxyxy	慢性胰腺炎
cjh	肠结核
cdnzj	肠道念珠菌病
mxcy	慢性肠炎
sezcky	十二指肠溃疡
wky	胃溃疡
jhxfmy	结核性腹膜炎
dnjsbdny	胆囊结石伴胆囊炎
jxwkz	急性胃扩张
xhdky	消化道溃疡
kyxjcy	溃疡性结肠炎
kleb	克罗恩病
mxdny	慢性胆囊炎
mxlwy	慢性阑尾炎
