12岁左右不能行走	运动障碍
1型糖尿病病史	糖尿病,1型糖尿病
24小时候气促消失	呼吸频率增快,呼吸困难,气促
24小时食管pH监测提示食管过度酸反流	食管反流
2型糖尿病病史	糖尿病,2型糖尿病
4字试验阳性	4字试验阳性
Allis征阳性	Allis征阳性
B 超检查：胆囊萎缩而壁厚	胆囊萎缩
BALF 淋巴细胞增高	淋巴细胞增多
BALF嗜酸性粒细胞增多	嗜酸性粒细胞增高,嗜酸性粒细胞升高,嗜酸性粒细胞增多
BALF嗜酸性粒细胞增高	嗜酸性粒细胞升高,嗜酸性粒细胞增多,嗜酸性粒细胞增高
BALF嗜酸粒细胞增多	嗜酸粒细胞升高,嗜酸粒细胞增多
Brudzinski征	布氏征阳性
Brudzinski征阳性	布氏征阳性
B超提示患侧附件及子宫直肠陷凹有液性暗区	子宫直肠陷凹
B超检查发现输卵管卵巢肿大，或形成边界不清的包块	卵巢肿大,输卵管肿大,输卵管肿块
B超检查提示腹腔内有少量积液，子宫、附件图像正常	腹腔内积液
B超示卵巢增大和腹腔积液	腹腔积液,卵巢增大
B超示双侧附件囊肿	附件囊肿
B超示子宫两侧及后方呈现圆形、椭圆形或不规则形无回声区,壁厚,内壁不光滑	子宫不规则
B超：孕中期双顶径每周增长＜2.0mm	孕
B超：羊水过少、胎盘老化	羊水过少
CA19-9增高	尿液儿茶酚胺减低
CD4+T淋巴细胞计数减少	CD4+T淋巴细胞计数减少
Coombs试验阳性	肌红蛋白阳性
CoxA16病毒感染	病毒感染
CRP增高	CRP升高
CT 显示肝内胆管的扩张和变形	肝内胆管扩张,胆管扩张
CTA示下肢动脉狭窄	动脉狭窄,下肢动脉狭窄
CT示甲状腺内边界模糊的低密度区	边界模糊
CT示肝内低密度影	肝内低密度影
CT示肾上腺肿瘤	腺瘤
CT示胰腺内结节影	胰腺结节影
CT示胸腺占位性病变	胸腺占位病变
CT示脑水肿	脑水肿
C反应蛋白增高	c反应蛋白升高
EB病毒DNA检查阳性	eb病毒dna阳性
EB病毒抗体阳性	EB病毒抗体阳性
EMG见尺神经在腕部受压征象	神经受压,腕部受压
EV71病毒感染	病毒感染
FGFR3基因突变	肾小球滤过率降低
FNAC示淋巴细胞浸润	淋巴细胞浸润
FNAC示滤泡细胞嗜酸性变	细胞嗜酸
FNAC示肉芽肿改变	肉芽肿,肉芽肿性炎症
HP感染检测阳性	感染
jackson发作	jackson发作
Kernig征阳性	克氏征阳性
K形样下肢畸形	下肢畸形
L4棘突旁压痛	棘突间压痛
L5棘突旁压痛	棘突间压痛
MRA示下肢动脉狭窄	下肢动脉狭窄,动脉狭窄
MRI动脉增强扫描可见肿块逐渐明显强化	mri增强
MRI动脉增强扫描向鞍上累及时呈“8字”或“雪人”征	mri增强
MRI示心包增厚	心包增厚
Murphy征阳性	Murphy征阳性
OT试验阳性	OT试验阳性
p-ANCA阳性	抗中性粒细胞抗体（ANCA）阳性
P2亢进	P2亢进
PAS染色阳性	PAS染色阳性
PPD阳性	PPD阳性
PR间期<0.12s	精子前向运动减低
PR间期>0.18s	精子前向运动减低
PR间期>0.2s	精子前向运动减低
PR间期≥0.12s	精子前向运动减低
SARS冠状病毒感染	病毒感染
SARS病毒抗体阳性	SARS病毒抗体阳性
ST段压低	ST-T改变
ST段呈水平型或下斜型压低≥1mm	ST-T改变
ST段弓背向上抬高	ST段抬高
ST段抬高	ST段抬高
ST段抬高，V1-V4抬高≥3mm	ST段抬高
Trendelenburg 征（单足站立试验）阳性	单足站立试验
TRH兴奋试验反应低下	反应差,反应迟钝,兴奋,反应低下
T波低平	T波低平
T波倒置	T波倒置
T波深倒置，双肢对称	T波倒置
Velcro啰音	湿啰音,肺部啰音,Velcro啰音
wallenberg综合征	wallenberg综合征
Whipple三联征	三联征
X 线检查可见似粟粒样肺结核阴影	肺结核
X线上纵隔阴影增宽	纵隔增宽,纵隔阴影
X线发现肺部有片状和斑片状阴影	肺部斑片状阴影
X线检查见升主动脉增宽	升主动脉增宽
X线示中上肺野纹理增粗	纹理增粗
X线示心包钙化	心包钙化
X线示心影扩大	心影增大
X线示肺不张	肺不张
X线见左心房增大	心脏增大,左心增大
X线食管异物影	食管异物
β2微球蛋白升高	球蛋白增高,球蛋白升高
γ-谷氨酰转移酶增高	γ-谷氨酰转移酶增高,γ-谷氨酰转移酶升高
“斜视”	斜视
“空、空”样咳嗽	咳嗽
一侧下腹部压痛阳性	下腹部压痛,腹部压痛
一侧下腹部反跳痛阳性	反跳痛,痛,下腹部反跳痛,腹部压痛,腹部反跳痛
一侧呼吸音减弱	呼吸音低,呼吸音减弱
一侧呼吸音消失	呼吸音消失,呼吸音低
一侧展神经麻痹	展神经麻痹
一侧耳部剧痛	侧耳剧痛
一侧肋脊角点压痛	肋脊角叩痛
一侧肢体运动障碍	运动异常,运动障碍,肢体运动障碍
一侧胸廓隆起	胸廓饱满
一侧腰部皱褶皮纹	腰部皱褶
一侧输尿管点压痛	输尿管疼痛
一度房室传导阻滞	房室传导阻滞
一时性排尿困难	排尿困难,排尿异常
一时性躁动不安	烦躁不安,躁动不安
一氧化碳中毒	一氧化碳中毒
一过性偏瘫	偏瘫
一过性偏身感觉障碍	偏身感觉障碍
一过性单侧肢体无力	四肢无力,肢体无力,乏力
一过性单侧肢体麻木	肢体麻木
一过性点状出血性皮疹	皮疹
一过性甲状腺毒症	甲状腺毒症
一过性第三心音	第三心音
一过性第四心音	第四心音
一过性黑曚	一过性黒曚,一过性黑曚
一过性黑朦	一过性黒曚,一过性黑朦
三偏症状	三偏症状
三凹征	三凹征阳性,三凹征
三叉神经支配区域感觉减退	三叉神经支配区域减退,感觉减退,三叉神经支配区域感觉减退,感觉障碍
三叉神经支配区域感觉过敏	感觉过敏,三叉神经支配区域感觉过敏,三叉神经支配区域过敏,感觉障碍
三叉神经支配区域感觉障碍	感觉障碍,三叉神经支配区域障碍,三叉神经支配区域感觉障碍
三叉神经痛	三叉神经痛
三叉神经眼支支配区疼痛	三叉神经痛,三叉神经疼痛
三叉神经麻痹	三叉神经麻痹
三尖瓣关闭不全	三尖瓣关闭不全
三尖瓣关闭不全的反流性杂音	三尖瓣关闭不全
三尖瓣区收缩期杂音	心尖区收缩期杂音,三尖瓣区收缩期杂音,收缩期杂音,三尖瓣杂音,心脏杂音
三度房室传导阻滞	房室传导阻滞
三相摩擦音	三相摩擦音
三碘甲状腺原氨酸（T3）升高	三碘甲状腺原氨酸增高,三碘甲状腺原氨酸升高
三角架征	三角架征
三角窝囊性隆起	三角窝隆起
三角纤维软骨损伤	软骨损伤,纤维损伤
三角肌假性肥大	三角肌肥大
三角肌疼痛	三角肌疼痛
三角颅畸形	三角颅畸形
上下肢动脉搏动不一致	上下肢动脉搏动不一致
上下肢血压相差较大	上下肢血压相差较大
上呼吸道、肺和肾病变	肾病
上呼吸道感染后喘憋	上呼吸道感染,憋喘,喘憋
上呼吸道感染后腹痛	上呼吸道感染,腹痛
上呼吸道感染症状	上呼吸道感染
上呼吸道感染表现	上呼吸道感染,上呼吸道感染表现
上呼吸道症状	呼吸道症状
上楼困难	上楼困难
上楼梯困难	上楼梯困难,上楼困难
上消化道出血	上消化道出血
上消化道出血表现	上消化道出血
上皮角化增生	上皮角化增生
上睑下垂	睑下垂
上肢僵硬	上肢僵硬
上肢关节强直	上肢关节强直,上肢强直,关节强直
上肢动作性震颤	上肢震颤
上肢发凉	上肢发凉,发冷,发凉
上肢外展	上肢外展
上肢多汗	上肢多汗,多汗
上肢意向性震颤	上肢震颤
上肢感觉障碍	上肢障碍,感觉障碍,上肢感觉障碍
上肢放射性疼痛	上肢疼痛,上肢痛
上肢放射痛	上肢放射痛,上肢痛
上肢无力	上肢无力,无力
上肢水肿	上肢水肿,水肿
上肢活动时疼痛加重	上肢痛,上肢加重,上肢疼痛
上肢活动障碍	上肢活动障碍,活动障碍,上肢障碍
上肢疼痛	上肢痛,上肢疼痛
上肢痛	上肢疼痛,上肢痛
上肢瘫痪	瘫
上肢紫绀较下肢重	发绀,紫绀
上肢肌萎缩	上肢肌萎缩,肌萎缩
上肢肿胀	上肢肿胀
上肢脉弱	脉弱,脉搏微弱,上肢脉弱
上肢腱反射亢进	腱反射亢进,反射亢进
上肢腱反射减弱	上肢腱反射减弱,上肢减弱,腱反射减弱
上肢腱反射消失	腱反射消失,上肢消失,上肢腱反射消失
上肢血压不能测出	上肢血压不能测出,血压测不出,上肢不能测出
上肢运动障碍	上肢运动障碍,运动障碍,运动异常
上肢近端轻瘫	上肢轻瘫
上肢酸痛	上肢痛,上肢酸痛
上肢高血压	高血压
上肢麻木	上肢麻木
上肢麻木无力	上肢麻木无力
上肺多发空洞	肺空洞
上腔静脉梗阻综合征	上腔静脉梗阻综合征
上腔静脉综合征	上腔静脉综合征
上腭震颤	上腭震颤
上腹不适	腹部不适,上腹不适
上腹中部疼痛	上腹疼痛,腹痛,上腹疼,上腹痛
上腹压痛	上腹压痛,腹部压痛
上腹张力性包块	腹包块
上腹振水音阳性	振水音
上腹灼热感	上腹灼热感
上腹烧灼感	上腹烧灼感
上腹疼痛	上腹疼痛,腹痛,上腹痛,上腹疼
上腹疼痛扩散至全腹	上腹疼痛,上腹痛,上腹疼,腹痛
上腹痛	上腹痛,腹痛
上腹痛后肩部酸痛	腹痛,肩痛,上腹痛
上腹突发剧痛	腹痛
上腹肿块	腹肿块,腹包块
上腹胀满不适	上腹不适,腹部不适,上腹胀满
上腹胀痛	腹痛
上腹膨胀	上腹膨胀
上腹轻压痛	上腹轻压痛,腹部压痛
上腹部不适	上腹不适,腹部不适
上腹部凹陷	上腹凹陷,腹部凹陷
上腹部包块	腹包块
上腹部压痛	上腹压痛,腹部压痛
上腹部囊性肿块	腹肿块,腹包块,上腹肿块
上腹部异常感觉	上腹异常,感觉异常
上腹部振水声	上腹振水声
上腹部收缩期杂音	收缩期杂音,心尖区收缩期杂音,心脏杂音
上腹部疼痛	上腹疼,上腹痛,上腹疼痛,腹痛
上腹部肿块	腹肿块,上腹肿块,腹包块
上腹部肿物	腹包块,腹肿块
上腹部胀痛	腹痛,上腹胀痛
上腹部脐两侧血管杂音	脐两侧杂音,上腹杂音,血管杂音
上腹部血管杂音	上腹杂音,血管杂音
上腹部触痛	腹部压痛
上腹部闻及连续性血管杂音	上腹杂音,血管杂音
上腹隐痛	腹痛,上腹隐痛
上腹饱胀感	上腹饱胀感
上臂红斑	上臂红斑,红斑
上臂肌肉萎缩	肌肉萎缩,肌萎缩,上臂萎缩,上臂肌肉萎缩
上臂肿胀压痛	上臂压痛,上臂肿胀
上臂部剧烈疼痛	上臂疼痛
上臂麻木	上臂麻木
上视不能	上视不能
上部巩膜暴露	巩膜暴露
上颌磨牙松动	磨牙,上颌松动
上颌磨牙疼痛	上颌疼痛,磨牙
下位运动神经元瘫痪	瘫,瘫痪
下呼吸道分泌物分离出肺炎衣原体	肺炎
下呼吸道分泌物腺病毒阳性	腺病毒阳性
下尺桡关节损伤	关节损伤
下尺桡关节脱位	关节脱位
下尿路刺激征	尿路刺激征
下尿路细菌定位培养阳性	定位阳性,尿路阳性
下楼无力	无力,下楼无力
下肢不对称性水肿	下肢水肿
下肢丹毒样皮炎	皮炎,下肢丹毒样
下肢乏力感	下肢乏力感
下肢传导束性感觉障碍	下肢障碍,感觉障碍,下肢感觉障碍
下肢传导束性运动障碍	运动障碍,运动异常,下肢运动障碍
下肢低血压	低血压,下肢低血压
下肢僵硬	下肢僵硬
下肢凹陷性水肿	下肢水肿
下肢刀割样剧痛	下肢刀割样,下肢疼痛
下肢动脉搏动减弱	下肢动脉搏动减弱,动脉搏动减弱
下肢发冷	肢体冷感,发冷,下肢发冷
下肢发凉	发凉,下肢发凉,发冷
下肢发绀	下肢发绀,发绀
下肢对称性水肿	下肢水肿
下肢弓形	下肢弓形
下肢怕冷	下肢怕冷,怕冷
下肢感觉异常	下肢感觉异常
下肢感觉障碍	感觉障碍,下肢感觉障碍,下肢障碍
下肢撕裂样痛	下肢疼痛
下肢无力	下肢无力
下肢无力行走后加重	下肢无力,下肢加重
下肢无汗	无汗,下肢无汗
下肢无脉	无脉,下肢无脉
下肢水肿	下肢水肿
下肢沉重感	下肢沉重感,下肢沉重
下肢浅感觉减弱	浅感觉减弱,下肢浅感觉减弱,下肢减弱
下肢浅感觉消失	浅感觉消失,下肢消失,下肢浅感觉消失
下肢浅静脉扩张	下肢浅静脉扩张,下肢扩张,浅静脉扩张
下肢浅静脉迂曲	浅静脉迂曲,下肢迂曲,下肢浅静脉迂曲
下肢深感觉减弱	下肢减弱,下肢深感觉减弱,深感觉减弱
下肢深感觉消失	下肢深感觉消失,深感觉消失,下肢消失
下肢湿疹	湿疹
下肢溃疡	下肢溃疡
下肢烧灼感	下肢烧灼感
下肢烧灼样痛	下肢疼痛
下肢电击感	下肢电击感
下肢疼痛	下肢疼痛
下肢痉挛	痉挛,下肢痉挛
下肢瘫痪	瘫,瘫痪
下肢皮下组织纤维化	下肢纤维化,下肢皮下组织纤维化,皮下组织纤维化
下肢皮温低	下肢皮温低,皮温低
下肢皮肤发紫	下肢皮肤发紫,下肢发紫,皮肤发紫
下肢皮肤增厚变硬	皮肤变硬,皮肤增厚
下肢皮肤湿疹	湿疹
下肢皮肤溃疡	皮肤溃疡,下肢溃疡,下肢皮肤溃疡
下肢皮肤紫绀	紫绀,发绀
下肢皮肤色素沉着	下肢色素沉着,下肢皮肤色素沉着,皮肤色素沉着
下肢皮肤苍白	下肢皮肤苍白,皮肤苍白
下肢紫绀	紫绀,发绀
下肢肌张力增高	下肢肌张力增高,肌张力增加,肌张力增高
下肢肌张力降低	肌张力减低,肌张力降低,下肢肌张力降低
下肢肌无力	肌无力,四肢无力,下肢肌无力
下肢肌束震颤	肌束震颤,肌束颤动,下肢震颤,下肢肌束震颤
下肢肌痛	肌痛,下肢肌痛
下肢肌萎缩	肌萎缩,下肢肌萎缩
下肢肿痛	下肢肿痛,下肢疼痛
下肢肿胀	下肢肿胀,肢体肿胀
下肢胀痛	下肢疼痛,下肢胀痛
下肢脉弱	下肢脉弱,脉弱,脉搏微弱
下肢腱反射亢进	反射亢进,腱反射亢进
下肢腱反射消失	下肢腱反射消失,腱反射消失,下肢消失
下肢自发运动不对称	下肢不对称,自发运动
下肢色素沉着	下肢色素沉着
下肢蚁走感	下肢蚁走感,蚁走感
下肢蠕动感	下肢蠕动感
下肢血压明显低于上肢	血压明显,上肢明显,下肢明显
下肢走路不稳	下肢不稳,下肢走路不稳,走路不稳
下肢远端不适感	下肢不适感
下肢远端发作性无力	下肢无力
下肢远端外侧痛觉减退	下肢减退,痛觉减退
下肢远端外侧触觉减退	触觉减退,触觉障碍,下肢减退
下肢远端痛觉减退	痛觉减退,下肢减退
下肢远端触觉减退	触觉减退,下肢减退,触觉障碍
下肢酸痛	下肢疼痛,下肢酸痛
下肢针刺感	下肢针刺感
下肢闪电样疼痛	下肢疼痛
下肢静息痛	下肢疼痛,下肢静息痛
下肢静脉扩张	下肢扩张,静脉扩张,下肢静脉扩张
下肢静脉迂曲	静脉迂曲,下肢静脉迂曲,下肢迂曲
下肢麻木	下肢麻木
下肢麻木无力	下肢麻木无力
下肺广泛纤维化	肺纤维化
下腰痛	下腰痛
下腰背痛	背痛
下腹剧烈触痛	腹部压痛
下腹剧痛	腹痛,下腹剧痛
下腹包块	下腹包块,腹包块
下腹压痛	下腹压痛,腹部压痛
下腹反跳痛	痛,腹部反跳痛,下腹反跳痛,反跳痛,腹部压痛
下腹坠痛	腹痛,下腹坠痛
下腹坠胀	腹胀,腹部不适,下腹坠胀
下腹坠胀不适	腹胀,下腹坠胀,下腹部不适,腹部不适
下腹平坦	下腹平坦
下腹持续性钝痛	下腹钝痛
下腹撕裂样剧痛	腹痛,下腹剧痛
下腹疼痛	下腹疼,腹痛,下腹痛,下腹疼痛
下腹痉挛样痛	痉挛
下腹痛	腹痛,下腹痛
下腹耻骨上膀胱区触痛	耻骨疼痛,膀胱区触痛,腹部压痛
下腹肌紧张	肌紧张,腹肌紧张,下腹肌紧张
下腹胀痛	腹痛
下腹部不适	腹部不适,下腹部不适
下腹部压痛	下腹部压痛,腹部压痛
下腹部反跳痛	腹部压痛,下腹部反跳痛,痛,腹部反跳痛,反跳痛
下腹部坠胀	下腹部坠胀,腹部不适,腹胀
下腹部局部肌紧张	下腹部肌紧张,腹部肌紧张
下腹部疼痛	腹痛,下腹部疼痛
下腹部耻骨上区肿块	腹包块,耻骨上区肿块,下腹部耻骨上区肿块,腹肿块,下腹部肿块
下腹部耻骨上区肿物	耻骨上区肿物,下腹部耻骨上区肿物,腹肿块,腹包块,下腹部肿物
下腹部肌紧张	腹部肌紧张,下腹部肌紧张
下腹部肿物	腹肿块,腹包块,下腹部肿物
下腹部触及囊性肿物	下腹部触及囊性肿物
下腹部酸胀感	下腹部酸胀感
下腹部隐痛	下腹部隐痛,腹痛
下腹钝痛	下腹钝痛
下腹阵发性绞痛	腹痛
下腹隐痛	下腹隐痛,腹痛
下腹隐痛不适	下腹隐痛,腹痛,腹部不适,下腹部不适
下象限盲	象限盲
下蹲困难	下蹲困难
下蹲无力	无力,下蹲无力
下颌下区压痛	下颌压痛
下颌下区肿胀	下颌肿胀
下颌下淋巴结肿大	颌下淋巴结肿大
下颌关节弹响	下颌关节弹响
下颌反射亢进	下颌反射亢进,反射亢进
下颌发育不良	发育障碍,发育不良,下颌发育不良
下颌增大前突	下颌增大前突
下颌尖细	下颌尖细
下颌淋巴结肿大	下颌淋巴结肿大,下颌肿大,淋巴结肿大
下颌疼痛	下颌疼痛
下颌短小	下颌短小
下颌角后方压痛	下颌压痛
下颌角后方肿胀	下颌肿胀
下颌骨破坏	下颌骨破坏
下鼻甲充血	鼻甲充血
下鼻甲溃疡	鼻甲溃疡
下鼻甲肉芽肿性增生	鼻甲增生
下鼻甲肥大	鼻甲肥大
下鼻甲肿胀	鼻甲肿胀
不典型失神	失神
不同程度意识障碍	意识障碍,意识不清
不孕	不孕
不存在从唤醒到完全清醒的时间延长	清醒
不存在睡眠中呼吸暂停	睡眠呼吸暂停,睡眠暂停,呼吸暂停,呼吸停顿
不存在睡眠时间不足	睡眠不足
不宁腿综合征	不宁腿综合征
不安	不安
不安腿综合征	不安腿综合征
不完全性痉挛性瘫痪	瘫痪,瘫
不对称性单瘫	单瘫
不对称性四肢瘫	四肢瘫
不对称性截瘫	截瘫
不对称性肌群无力	无力
不对称瘫痪	瘫痪,瘫
不平衡感	不平衡感
不影响智力	智力不影响
不影响生长发育	生长发育不影响
不思饮食	饮食不思
不愿戴手套	不愿戴手套
不愿穿袜子	不愿穿袜子
不敢进食	进食不敢
不明原因关节肿胀	关节肿,关节肿胀,关节不明
不明原因发热	发热
不易受孕	不易受孕
不育	不育
不育症	不育,不育症
不能平卧	不能平卧
不能抬小腿走路	走路不能,抬小腿不能
不能持重	不能承重,不能持重
不能摆脱强迫症状	强迫症
不能皱额蹙眉	不能皱额,蹙眉
不能站立	不能站立,站立不稳
不能站立和下床活动	不能站立,站立不稳
不能耐受疲劳	疲劳,疲惫
不能行走	运动障碍
不能识别熟人面孔	识别熟人面孔不能
不能进食	进食不能
不自主运动	不自主运动
不规则上腹隐痛	上腹隐痛,腹痛
不规则低热	低热,发热
不规则阴道出血	阴道出血
不规则阴道流血	阴道出血,阴道流血
不随意运动	不随意运动
与体位有关的呼吸困难	呼吸困难,气促
与体位有关的眩晕	眩晕
与体位相关性呼吸困难	气促,呼吸困难
与家人关系不协调	与家人关系不协调
丘疱疹	疱疹
丘疹	丘疹,皮疹
丘疹伴疱疹	疱疹,丘疹,皮疹
丘疹易发生糜烂渗液	丘疹,皮疹
丘疹根部有蒂	丘疹,皮疹
丘疹表面脱屑	脱屑,丘疹,皮疹
丘疹顶端有小水疱	丘疹,皮疹,水疱
丘脑性失语	丘脑性失语
丘脑性痴呆	丘脑性痴呆
丙氨酸氨基转移酶增高	谷丙转氨酶升高
两上肺野出现圆形小阴影	肺野阴影
两侧大腿内侧皮肤皱褶不对称	皮肤皱褶不对称,大腿不对称
两侧肋脊角压痛	肋脊角压痛,肋脊角叩痛
两侧肩胛骨不等高	肩胛骨不等高
两侧肾区扪及巨大囊性感肾	肾区扪及巨大囊性感肾
两侧输尿管点压痛	输尿管疼痛
两侧面肌抽搐	面肌抽搐
两性畸形	两性畸形
两手颤动	手抖
两眼不能上视	上视不能,两眼不能,两眼不能上视
两眼向病灶侧凝视麻痹	两眼向病灶侧凝视麻痹
两眼距增宽	两眼距增宽
两肋部胀痛	两肋部胀痛
两肩不等高	两肩不等高
两肺密集阴影	肺部阴影
两肺过清音	两肺过清音,过清音
两肾大小不对称	两肾大小不对称
严重出血	出血
严重四肢酸痛	四肢疼痛,四肢酸痛
严重失能	失能
严重意识障碍	意识不清,意识障碍
严重贫血	贫血
丧失进取心	进取心丧失
个性改变	个性改变
中上腹不适	腹部不适,上腹不适
中上腹压痛	腹部压痛
中上腹痛	上腹痛,腹痛
中上腹肌紧张及反跳痛	反跳痛,腹部压痛,肌紧张,痛
中上腹胀痛	腹痛
中上腹隐痛	上腹隐痛,腹痛
中上腹饱胀不适	腹部不适,上腹不适
中小量心包积液	心包积液
中左上腹痛	腹痛,上腹痛
中度发热	发热
中度热	中度热
中度脾大	脾大
中度贫血	中度贫血
中心体温升高不超过40℃	发热,高热,体温升高
中心体温超过40℃	发热,高热
中心静脉压升高	静脉压增高,静脉压升高
中性粒细胞减少	中性粒细胞降低,中性粒细胞减少
中性粒细胞增多	中性粒细胞升高,中性粒细胞增多
中性粒细胞百分比升高	中性粒细胞百分比升高
中性粒细胞缺乏	中性粒细胞缺乏
中性粒细胞计数增多	中性粒细胞增多,中性粒细胞升高
中指不能屈曲	中指不能屈曲
中枢性呼吸障碍	呼吸障碍
中枢性高热	发热,高热
中段尿结核菌培养阳性	尿阳性
中毒性休克	休克
中毒性巨结肠表现	中毒性巨结肠,中毒性巨结肠表现
中细湿罗音	细湿罗音
中耳炎	中耳炎
中耳炎病史	中耳炎
中耳胆脂瘤病史	中耳胆脂瘤
中腹部隐痛	中腹隐痛
中鼻甲息肉样变	中鼻甲息肉
中鼻甲肥大	鼻甲肥大
中鼻道变窄	中鼻道变窄
中鼻道膨隆	中鼻道膨隆
临床表现不典型	临床表现不典型
丹毒样皮炎	皮炎
主动脉影增宽	主动脉增宽
主动脉扩张	主动脉扩张
主动脉根部扩张	主动脉扩张
主动脉瓣关闭不全	主动脉瓣关闭不全
主动脉瓣区收缩期吹风样杂音	主动脉瓣区收缩期吹风样杂音
主动脉瓣区收缩期喷射性杂音	心脏杂音,心尖区收缩期杂音,主动脉瓣区杂音,收缩期杂音
主动脉瓣区第二心音亢进	主动脉瓣区第二心音亢进,P2亢进
主动脉瓣区舒张期叹气样杂音	主动脉瓣区杂音
主动脉瓣区闻及舒张中期杂音	主动脉瓣区杂音
主动脉瓣狭窄	主动脉缩窄,主动脉瓣狭窄
主动脉瘤	主动脉瘤
主动脉瘤样扩张	主动脉瘤
主动脉窦扩张	主动脉扩张
主动脉缩窄	主动脉缩窄
举步困难	举步困难
举臂时肩胛骨内侧远离胸壁	肩胛骨远离,胸壁远离
久坐后不能立即站立	站立不能
久坐疼痛加重	久坐疼痛,久坐加重
乏力	乏力
乘船后眩晕	眩晕
乘车后眩晕	眩晕
书写障碍	书写障碍
乳头乳晕着色加深	乳头乳晕着色加深,乳头着色加深,乳晕着色加深
乳头凹陷	乳头凹陷
乳头分泌类初乳	乳头分泌
乳头发育不良	乳头发育不良,发育障碍,发育不良
乳头扁平	乳头扁平
乳头湿疹样乳腺癌	湿疹样乳腺癌,乳头湿疹样乳腺癌
乳头溢液呈暗棕色	乳头溢液暗棕色
乳头溢液呈黄色	乳头溢液黄色
乳头被牵向癌肿一侧	癌肿
乳房“酒窝征”	酒窝征
乳房下色素沉着	乳房色素沉着
乳房下雀斑	乳房雀斑
乳房不发育	乳房不发育
乳房内结节	乳房内结节
乳房增大	乳房增大
乳房局部波动感	乳房波动感
乳房局部皮肤凹陷	乳房凹陷,皮肤凹陷
乳房弥漫性增厚	乳房增厚
乳房无痛肿块	乳房肿块
乳房早发育	乳房早发育
乳房疼痛	乳房痛,乳房疼痛
乳房瘘管	瘘管,乳房瘘管
乳房皮温增高	皮温升高,乳房增高,乳房皮温增高
乳房皮肤冷脓肿	皮肤冷,脓肿,乳房冷
乳房皮肤橘皮样水肿	乳房水肿,皮肤肿胀,皮肤水肿
乳房皮肤溃疡	乳房皮肤溃疡,皮肤溃疡,乳房溃疡
乳房皮肤破溃	乳房皮肤破溃,皮肤破溃,乳房破溃
乳房皮肤色素沉着	皮肤色素沉着,乳房皮肤色素沉着,乳房色素沉着
乳房红肿	乳房红肿
乳房结节	乳房结节
乳房肿块	乳房肿块
乳房肿块与皮肤粘连	乳房粘连,乳房肿块,皮肤粘连,皮肤肿胀
乳房肿块易于推动	乳房肿块,乳房易于推动
乳房肿块表面光滑	乳房肿块,乳房表面光滑
乳房肿块质地似橡皮球	乳房似橡皮球,乳房肿块质地似橡皮球,肿块质地似橡皮球
乳房胀痛	乳房痛,乳房胀痛
乳房脓肿形成	脓肿,乳房形成
乳晕区小结节	乳晕区小结节
乳晕色素浅淡	乳晕浅淡,乳晕色素浅淡,色素浅淡
乳磨牙早失	磨牙
乳磨牙缺失	磨牙
乳突压痛	乳突压痛
乳突部压痛	乳突部压痛,乳突压痛
乳突部肿胀	乳突部肿胀
乳糜尿	乳糜尿
乳糜泻	腹泻,乳糜泻
乳糜胸	乳糜胸
乳糜腹腔积液	腹腔积液
乳酸脱氢酶升高	血乳酸脱氢酶增高,乳酸脱氢酶升高
乳酸脱氢酶（LDH）升高	血乳酸脱氢酶增高,乳酸脱氢酶升高
二便失禁	二便失禁
二尖瓣关闭不全	二尖瓣关闭不全,二尖瓣闭合不良
二尖瓣反流	二尖瓣闭合不良,二尖瓣反流
二尖瓣反流束呈偏心性	二尖瓣闭合不良,二尖瓣反流
二尖瓣狭窄	二尖瓣狭窄
二尖瓣瓣叶增厚	二尖瓣瓣叶增厚,瓣叶增厚
二尖瓣的位置、形态和活动正常，左心室增大	左心室扩大
二尖瓣脱垂	二尖瓣脱垂
二尖瓣面容	二尖瓣面容
二度房室传导阻滞	房室传导阻滞
二氧化碳分压增高	二氧化碳分压升高,二氧化碳分压增高
二氧化碳潴留	二氧化碳潴留
交叉性瘫痪	瘫痪,瘫
交替脉	交替脉
交通性脑积水表现	脑积水
产后情绪低落	情绪低落
产后无乳	产后无乳
产后阴道大出血	阴道大出血
产瘤较大	产瘤
产程延长	产程延长,产程异常
人格变态	人格变态
人格改变	人格改变
仅有腹部不适	腹部不适
仅有腹部隐痛	腹痛,腹部隐痛
他觉性耳鸣	他觉性耳鸣
代谢性碱中毒	代谢性碱中毒
代谢性酸中毒	代谢性酸中毒
以躯干为轴的扭转	躯干扭转
仰卧起立时先患侧膝关节弯曲	膝关节弯曲
任何微小的被动性伸指活动引起剧痛	活动剧痛
休克	休克
休息可缓解头痛	头痛
休息后胸痛缓解	胸痛
休息时有心衰症状	心衰
会厌充血	会厌充血
会厌明显充血肿胀	会厌明显,会厌肿胀,会厌充血
会厌水肿	会厌水肿
会厌肿胀	会厌肿胀
会厌脓肿	脓肿
会厌舌面半球形	会厌半球形,舌面半球形,会厌舌面半球形
会阴伤口压痛	会阴伤口压痛,会阴部压痛,伤口压痛
会阴伤口红肿发硬	伤口发硬,会阴发硬,会阴红肿,伤口红肿
会阴伤口黏膜充血水肿	黏膜充血,会阴水肿,会阴充血,伤口水肿,黏膜水肿,伤口充血
会阴溃疡	会阴溃疡
会阴痛	会阴部疼痛,会阴痛
会阴皮肤瘙痒	皮肤瘙痒,会阴皮肤瘙痒,会阴瘙痒
会阴部不适	会阴部不适
会阴部增宽	会阴部增宽
会阴部感觉障碍	会阴部感觉障碍,感觉障碍,会阴部障碍
会阴部疼痛	会阴部疼痛
会阴部瘙痒	会阴部瘙痒
会阴部蝴蝶形血肿	血肿
会阴部血肿	血肿
传导性聋	聋
传导束性感觉障碍	感觉障碍
伤口出血时间延长	出血时间延长,伤口延长,伤口出血时间延长
伤口恶臭	伤口恶臭
伤口愈合延迟	伤口愈合延迟
伤口附近感觉异常	伤口感觉异常
伤后当时清醒	清醒
伤后持续昏迷(>6小时）	昏迷,昏厥,意识不清
伤肢沉重	伤肢沉重
伤肢疼痛	伤肢疼痛
伸肌腱牵拉试验阳性（Mills征）	伸肌腱牵拉试验阳性
伸腕时疼痛加重不能持物	伸腕疼痛,伸腕加重
伸舌偏斜	伸舌偏斜
伸舌无力	伸舌无力,无力
位置觉减退	位置觉障碍,位置觉减退
位置觉缺失	位置觉障碍,位置觉缺失
低体温	体温低
低头时项背部下肢放射性麻木	项背麻木,下肢麻木
低头时项背部下肢触电样疼痛	项背疼痛,下肢疼痛
低密度脂蛋白胆固醇增高	低密度脂蛋白胆固醇增高
低密度脂蛋白胆固醇降低	低密度脂蛋白胆固醇降低
低尿酸血症	低尿酸血症
低心排血量综合征	低心排血量综合征
低氧血症	低氧血症
低渗透压尿	渗透压低,尿低
低热	发热,低热
低热卡试验阳性	发热,低热
低白蛋白血症	血症
低磷血症	血症
低蛋白血症	低蛋白血症
低血压	低血压
低血糖	低血糖
低血糖昏迷8～12小时以上	低血糖昏迷
低血糖症	低血糖症,低血糖
低血糖症状	低血糖症,低血糖
低血钠	低血钠
低血钾	血钾低
低血钾性碱中毒	碱中毒
低钙性抽搐	抽搐
低钠血症	低钠血症
低钾型周期性麻痹家族史	低钾型周期性麻痹
低钾血症	低钾血症,低钾血
体位性低血压	低血压
体位性头昏	头昏
体位性头痛	头痛
体位性排尿中断	排尿中断
体位性眼球突出	眼球突出
体位改变后突然发生一侧下腹剧痛	下腹改变,体位剧痛,下腹剧痛,体位改变,腹痛
体力活动后喘憋	喘憋,体力活动后喘憋,憋喘
体力活动后胸痛	胸痛,体力活动后胸痛
体力活动明显受限	活动受限,活动明显,体力明显
体力活动轻微受限	活动受限,体力受限
体力衰弱	体力衰弱
体力衰退	体力衰退
体格发育过快	体格发育过快
体温不升	体温不升
体温不高	体温低,体温不高
体温低	体温低
体温偏低	体温偏低,体温低
体温升高	体温升高
体温超过39℃	发热,中度热
体温降低	体温降低
体温＞39℃	中度热,发热
体象障碍	体象障碍
体质虚弱	体质虚弱
体重下降	体重减轻,体重下降
体重不增	体重不增
体重低下	体重低下
体重减轻	体重减轻
体重增加	体重增加
体重增加不良	体重增加
体重增长缓慢	体重增长缓慢
体重增长过快	体重增加迅速,体重增长过快
体重降低	体重减轻,体重降低
作呕	作呕
侏儒症	侏儒症
侧下腹腹肌紧张	腹肌紧张
侧下腹部肿物	下腹部肿物,腹肿块,腹包块
侧弓反张	侧弓反张
侧腹痛	腹痛
便中含假膜	假膜
便中带黏液	便中黏液
便中见豆腐渣样细块	大便豆腐渣样
便前肛门有下坠感	肛门下坠感,肛门坠胀
便失禁	便失禁
便常规白细胞阳性	白细胞阳性
便意减弱	便意减弱
便秘	便秘
便秘腹泻交替	腹泻,便秘
便血	便血
便血性腹泻	腹泻
便频	便频
促甲状腺激素（TSH）降低	tsh降低
俯卧位腹痛减轻	腹痛
倦态乏力	倦态,乏力
倦怠	倦怠
倦怠乏力	倦怠,乏力
假两性畸形	假两性畸形
假孕症状	假孕
假性上睑下垂	睑下垂
假性延髓性麻痹	延髓性麻痹
假性延髓麻痹	延髓麻痹
假膜广泛灰黄污秽	假膜
偏侧感觉障碍	感觉障碍
偏头痛	头痛,偏头痛
偏头痛发作	偏头痛,偏头痛发作,头痛
偏执-强迫行为	行为强迫
偏瘫	偏瘫
偏盲	偏盲
偏身感觉缺失	偏身感觉缺失
偏身感觉障碍	偏身感觉障碍
偏身舞蹈	偏身舞蹈
偏身萎缩	偏身萎缩
偏食萎缩	偏食萎缩,偏食
做恶梦	做恶梦
停止排便排气	无排气排便
停止饮酒后出血头痛	头痛,出血
停止饮酒后出血焦虑	焦急,出血,焦虑
停止饮酒后失眠	失眠
停用激素后高血糖逐渐缓解	高血糖
停经	停经
停经史	停经史
停经后不规则阴道出血	阴道出血
停经后腹痛	腹痛
停经后阴道流血	阴道流血,阴道出血
健忘	健忘
健谈	健谈
傍晚低热	发热,低热
傻笑	傻笑
僵硬感	僵硬感
儿童发音迟缓	发音迟缓
儿童常“夜啼”	夜啼
儿童性发育障碍	性发育障碍
儿童智力障碍	智力障碍
儿童生长发育受阻	生长发育受阻
儿童生长发育迟缓	发育障碍,生长发育迟缓,生长迟缓
充溢性尿失禁	尿失禁,大小便失禁
充血性心力衰竭	充血性心力衰竭
先天性无子宫	无子宫
先露部高浮	先露部高浮
光反射消失	光反射消失,对光反射消失
光过敏	光过敏
光锥变形	光锥变形
光锥消失	光锥消失
光锥缩短	光锥缩短
克氏征阳性	克氏征阳性
免疫力低下	免疫力低下
免疫功能减弱	免疫功能减弱
免疫球蛋白升高	免疫球蛋白升高
免疫球蛋白降低	免疫球蛋白降低
入睡前幻觉	幻觉
入睡困难	入睡困难
全收缩期杂音	全收缩期杂音
全眼外肌瘫痪	瘫,瘫痪
全眼炎	全眼炎
全眼肌麻痹	全眼肌麻痹,肌麻痹
全腹压痛	全腹压痛,腹部压痛
全腹反跳痛	反跳痛,痛,腹部压痛,腹部反跳痛,全腹反跳痛
全腹疼痛	全腹疼痛,全腹痛,腹痛
全腹痛	腹痛,全腹痛
全腹腹胀	全腹腹胀,腹部不适,腹胀
全血细胞减少	全血细胞减少
全身不适	全身不适
全身中毒症状	全身中毒
全身乏力	全身乏力,乏力
全身倦怠感	全身倦怠感
全身多处脓肿	脓肿
全身性水肿	水肿
全身恶病质	全身恶病质,恶病质
全身感染性症状不明显	全身感染性症状不明显,全身感染性症状
全身感觉过敏	感觉过敏,全身感觉过敏,感觉障碍
全身抽搐	全身抽搐
全身无力	无力,全身无力
全身毒血症症状	毒血症
全身水肿	全身水肿
全身游走样性疼痛	全身疼痛,全身痛
全身疼痛	全身痛,全身疼痛
全身症状	全身症状
全身症状多不明显	全身症状
全身痛	全身痛,全身疼痛
全身皮肤色素加深	皮肤色素加深,全身加深,全身皮肤色素加深
全身肌无力	四肢无力,肌无力,全身肌无力
全身肌肉出现粗大震颤	全身粗大震颤,全身出现,肌肉出现,肌肉粗大震颤
全身肌肉压痛	肌肉压痛,全身痛,全身肌肉压痛,肌痛
全身肌肉痛	全身痛,全身肌肉痛,肌肉痛,肌痛,肌肉疼痛
全身肌肉萎缩	全身肌肉萎缩,肌肉萎缩,全身萎缩,肌萎缩
全身肌肉酸痛	全身酸痛,肌痛,全身肌肉酸痛,全身痛,肌肉酸痛
全身肌肉骨骼疼痛	肌痛,骨骼疼痛,骨痛,全身痛
全身衰弱	全身衰弱,全身衰竭
全身衰竭	全身衰竭
全身酸痛	全身痛,全身酸痛
全身骨痛	全身骨痛,骨痛
全身骨骼肌普遍性肌强直	肌强直,肌肉强直
全身骨骼肌普遍性肌肥大	骨骼肌肌肥大,全身肌肥大
共济失调	共济失调
共济失调性偏瘫	偏瘫
共济失调性轻偏瘫	轻偏瘫
关节不适	关节不适
关节位置形态异常	关节位置形态异常
关节僵直	关节僵直,关节僵硬
关节僵硬	关节僵硬
关节出血	关节出血
关节剧痛	关节剧痛,关节痛
关节功能障碍	关节功能障碍
关节半脱位	关节半脱位
关节压痛	关节痛,关节压痛
关节发红	关节发红
关节在活动过程中突然打软	关节突然,关节打软,活动打软,活动突然
关节处压痛	关节痛,关节压痛
关节尺侧偏斜	关节偏斜
关节局部发热	关节发热
关节局部红肿热痛	关节疼痛,关节痛
关节屈曲位	关节屈曲
关节屈曲处皮肤溃疡	皮肤屈曲,皮肤溃疡,关节屈曲,关节溃疡
关节屈曲挛缩不能伸直	关节不能伸直,关节屈曲,关节挛缩
关节强直	关节强直
关节挛曲	关节挛曲
关节挛缩	关节挛缩
关节摩擦感	关节摩擦感
关节无力	无力,关节无力
关节无畸形	关节无畸形
关节梭形肿胀	关节肿,关节肿胀
关节活动受限	关节活动受限
关节活动障碍	关节功能障碍,关节活动障碍
关节液浆液性	关节液浆液性
关节温度增高	温度增高,关节温度增高,关节升高,温度升高,关节增高
关节灼热	关节灼热
关节炎	关节炎
关节炎症状	关节炎
关节畸形	关节畸形
关节疼痛	关节疼痛,关节痛
关节痛	关节痛
关节积液	关节积液
关节积血	关节积血
关节红	关节红
关节红疹	红疹,关节红疹
关节红肿	关节肿,关节红肿
关节红肿热痛	关节疼痛,关节痛
关节红肿疼痛	关节红肿,关节痛,关节肿,关节疼痛
关节绞锁现象	关节绞锁
关节肌肉疼痛	肌肉痛,关节肌肉疼痛,肌肉疼痛,关节痛,肌痛
关节肥大	关节肥大
关节肿	关节肿
关节肿大	关节肿,关节肿大
关节肿物	关节肿物,关节肿
关节肿痛	关节肿痛,关节痛,关节肿
关节肿胀	关节肿胀,关节肿
关节胶化	关节胶化
关节腔积液	关节腔积液
关节被动痛	关节疼痛,关节被动,关节痛
关节酸痛	关节酸痛,关节痛
关节酸胀	关节酸胀
关节间隙不平整	关节不平
关节间隙狭窄	关节狭窄
关节附件肿块	附件肿块,关节肿,关节附件肿块
关节附近的骨突与肌腱间压痛	关节痛,关节压痛,肌腱压痛
关节附近的骨突与肌腱间疼痛	肌腱疼痛,关节痛
兴奋	兴奋
兴奋症状	兴奋
其他皮肤反复溃疡	皮肤溃疡
其他脏器功能不全表现	其他脏器功能不全表现,其他脏器功能不全
内分泌系统功能障碍	内分泌功能障碍
内分泌紊乱	内分泌紊乱
内收肌压痛	内收肌压痛
内收肌紧张	肌紧张
内斜视	内斜视
内痔和外痔症状同时存在	外痔,内痔,症状存在
内痔脱出	内痔
内直肌麻痹	内直肌麻痹
内眦赘皮	内眦赘皮
内镜见贲门下搏动性出血	出血
冈上肌钙盐沉着	肌沉着
再次服用数小时内再次发热	发热
写作困难	写作困难
军团菌抗体阳性	军团菌抗体阳性
冠状动脉供血不足	冠状动脉供血不足
冠状动脉狭窄	冠状动脉狭窄
冠状动脉瘤	冠状动脉瘤
冠状动脉管壁钙化	冠状动脉管壁钙化
冰冻骨盆	冰冻骨盆
冲动行为	冲动行为,易激动
冷水试验阳性	冷水试验阳性
冷汗	冷汗
冻结现象	冻结现象
减反射减弱	减反射减弱
减反射消失	减反射消失
凝血功能异常	凝血功能异常
凝血时间延长	凝血时间延长
凝血障碍	凝血障碍
凝视	凝视
凝视麻痹	凝视,凝视麻痹
凝视鼻尖	凝视
凹陷性水肿	水肿
出冷汗	出冷汗
出汗	出汗
出汗增多	出汗,出汗增多
出汗异常	出汗异常,出汗
出牙延迟	出牙延迟
出生24小时内出现黄疸	黄疸
出生3个月内出现肾病综合征	肾病综合征
出生后不排粪便	不排粪便
出生后哭声低	哭声低
出生后排便延迟	排便延迟
出生后背部中线有一个肿物膨出	背部肿物,背部膨出
出血	出血
出血不止	出血,出血不止
出血倾向	出血倾向
出血倾向较轻	出血倾向,出血倾向较轻
出血性皮疹	皮疹
分离性感觉障碍	分离性感觉障碍
分离性斜视	斜视
切口瘢痕处肿块	切口瘢痕处肿块,瘢痕处肿块,切口肿块
创伤后出血	出血
初潮延迟	初潮延迟
初站立时感觉关节不稳定	感觉不稳定,关节不稳定
判断力下降	判断力降低,判断力下降
判断力降低	判断力降低
判断力障碍	判断力障碍
刮取皮疹或疱疹的基底层组织涂片找到巴兴小体	疱疹,皮疹
刺激性咳嗽	咳嗽
刺激性干咳	咳嗽,干咳
前倾位呼气末杂音明显	呼气杂音,呼气明显
前冲步态	前冲步态
前列腺压痛	前列腺压痛
前列腺增大	前列腺增大,前列腺肿大
前列腺增大无硬结	前列腺肿大,前列腺无硬结,前列腺增大
前列腺硬结	前列腺硬结
前列腺结节质地坚硬	前列腺结节,前列腺质地坚硬
前列腺肿大触痛	前列腺压痛,前列腺肿大
前列腺肿胀	前列腺肿大,前列腺肿胀
前列腺饱满	前列腺饱满
前囊自发穿孔	前囊自发穿孔
前囟凹陷	前囟凹陷
前囟增大	前囟隆起,前囟增大
前囟大	前囟大
前囟扩大	前囟隆起,前囟扩大
前囟膨隆	前囟隆起,前囟膨隆
前囟闭合延迟	前囟闭合,前囟延迟
前囟隆起	前囟隆起
前囟饱满	前囟饱满
前囟饱满隆起	前囟饱满,前囟隆起
前庭功能改变	前庭改变,前庭功能改变,功能改变
前庭大腺局部波动感	前庭大腺波动感
前庭大腺局部皮肤压痛明显	前庭大腺压痛,前庭大腺明显,皮肤压痛,皮肤明显
前庭大腺局部皮肤发热	发热,皮肤发热
前庭大腺局部皮肤红肿	皮肤红肿,皮肤肿胀,前庭大腺红肿
前庭大腺开口处见白色小点	开口处小点,前庭大腺小点,开口处白色,前庭大腺白色
前弯时两侧背部不对称	背部不对称
前极性白内障	白内障
前羊膜囊不明显	羊膜囊不明显
前腹壁静脉曲张	腹壁静脉曲张
前臂伸直位旋后不能	前臂旋后不能,前臂伸直位旋后不能,伸直位旋后不能
前臂功能障碍	前臂功能障碍
前臂旋前不能	前臂旋前不能
前臂旋后障碍	前臂旋后障碍
前臂畸形	前臂畸形
前臂疼痛	前臂疼痛
前臂肿胀	前臂肿胀
前臂骨擦音	骨擦音,前臂骨擦音
前葡萄膜炎	葡萄膜炎
前锥形晶状体	晶状体前锥形
前额突出	前额突出
前额部周期性头痛	头痛
前额部周期痛	前额周期痛
前额隆起	前额突出,前额隆起
前驱呼吸道感染	呼吸道感染,前驱呼吸道感染
前驱感染史	感染
剑突下凹陷	剑突下凹陷
剑突下剧烈腹痛	腹痛
剑突下压痛	剑突下压痛
剑突下可有局限性压痛	剑突下压痛
剑突下心脏搏动增强	剑突下搏动,心脏搏动,剑突下增强,心脏增强
剑突下持续性钝痛	剑突下钝痛
剑突下收缩期抬举样搏动	剑突下搏动
剑突下深压痛	剑突下压痛,剑突下深
剑突下烧灼感	剑突下烧灼感
剑突下钻顶样剧烈绞痛	剑突下绞痛,剑突下钻顶样
剑突与脐之间触到橄榄状的肿块	剑突肿块,剑突橄榄状
剧烈呕吐	呕吐
剧烈呕吐后上腹膨隆变平坦萎陷	上腹膨隆变平坦萎陷
剧烈头痛	头痛
剧烈摔倒	摔倒
剧烈活动诱发腹痛	腹痛
剧烈眼痛	眼痛
剧烈胸痛	胸痛
剧烈腰痛	腰痛
剧烈腹泻	腹泻
剧烈腹痛	腹痛
剪刀步态	剪刀步态
副流感病毒阳性	流感病毒感染,流感病毒阳性
动作中断	动作中断
动作停止	动作停止
动作减少	动作减少
动作发育落后甚至退步	动作退步,发育退步,发育障碍,动作落后
动作增多	动作增多
动作笨拙	动作迟缓,动作笨拙
动作缓慢	动作缓慢,动作迟缓
动作迟缓笨拙	动作迟缓,动作笨拙
动眼神经不全麻痹	动眼神经不全,动眼神经麻痹
动眼神经麻痹	动眼神经麻痹
动脉导管未闭	动脉导管未闭
动脉栓塞	动脉栓塞
劳力性呼吸困难	呼吸困难,气促
劳力性心悸	心悸
劳力性胸痛	胸痛
劳动耐力下降	劳动耐力下降
劳累后加重血尿	血尿
劳累后右上腹胀痛	腹痛
勃起机能障碍	勃起功能障碍,勃起机能障碍
匀称性身材矮小	身材矮小,生长迟缓
包块随肌腱活动	肌腱包块,活动包块
包皮内刺痒	包皮内刺痒
包皮内灼痛	包皮内灼痛
包皮内触及硬块	包皮内触及,包皮内硬块
包虫囊液引起过敏症表现	包虫囊液
包虫囊液皮内试验阳性	包虫囊液,皮内试验阳性
包虫囊破溃症状	症状破溃,包虫囊
化脓性中耳炎症状	中耳炎
匙状甲	匙状甲
升主动脉内径明显增宽	升主动脉增宽
午后低热	发热,低热
午夜关节剧痛	午夜关节剧痛,关节痛,关节剧痛
半球形疝块	疝块半球形
协调性差	协调性差
卒中样发作	卒中样发作
单侧不能蹙眉	不能蹙眉
单侧头痛	头痛
单侧眼睑下垂	眼睑下垂
单侧眼裂不能闭合	眼裂不能闭合
单侧肢体感觉障碍	肢体感觉障碍,肢体障碍,感觉障碍
单侧肢体活动不利	肢体不利,活动不利
单侧胸痛	胸痛
单侧阴囊剧痛	阴囊疼痛
单侧面肌瘫痪	瘫,瘫痪
单侧高频耳鸣	耳鸣
单发关节肿痛	关节肿,关节痛,关节肿痛
单瘫	单瘫
单眼一过性黑曚	一过性黒曚,一过性黑曚,单眼一过性黑曚
单眼一过性黒曚	黒曚
单眼发病	单眼发病
单眼可逆性视觉障碍	单眼障碍,视觉障碍
单眼失明	失明
单眼暗点	单眼暗点
单眼闪烁	单眼闪烁
卧位弯腰反酸加重	反酸,弯腰加重
卧床不起	卧床不起
卧床取被动体位	体位被动
卵圆孔未闭	卵圆孔未闭
卵巢不发育	卵巢不发育
卵巢功能低下	卵巢功能低下
卵巢呈条索状无功能实体	卵巢条索状
卵巢和子宫增大	卵巢增大,子宫增大
卵巢炎	卵巢炎
卵巢黄素化囊肿	卵巢黄素化囊肿
压力性尿失禁	压力性尿失禁
压力觉异常	压力觉异常
压头试验阳性	压头试验阳性
压头试验阳性（Spurling征）	压头试验阳性
压抑	压抑
压痛向足背放射	足背压痛,足背放射
压迫耳屏时眩晕	耳屏压迫,眩晕
厌油	厌油
厌油腻	厌油腻
厌食	厌食
原发性闭经	原发性闭经
原发病症状	原发病症状
原发癌表现	原发癌
原发肿瘤症状	原发肿瘤症状
原有呼吸道症状加重	呼吸困难加重,原有呼吸道症状加重
去大脑强直	去大脑强直
去大脑强直发作	去大脑强直,去大脑强直发作
去皮质强直	去皮质强直
去皮质状态	去皮质状态
去脑强直	去脑强直,去大脑强直
去脑强直发作	去大脑强直,去脑强直发作,去脑强直
双上肢共济失调	共济失调,双上肢共济失调
双上肢收缩压差大于10mmHg	双上肢差,收缩压差
双上肢血压不对称	双上肢血压不对称,血压不对称,双上肢不对称
双上肢血压不等	血压不等,双上肢不等,双上肢血压不等
双下肢位置觉障碍	双下肢位置觉障碍,双下肢障碍,位置觉障碍
双下肢僵硬	双下肢发硬,双下肢僵硬
双下肢凹陷性水肿	下肢水肿,双下肢水肿
双下肢发硬	双下肢发硬
双下肢无力	无力,双下肢无力
双下肢水肿	下肢水肿,双下肢水肿
双下肢紫癜	紫癜
双下肢进行性肌张力增高	双下肢增高,肌张力增加,肌张力增高
双下肢震动觉障碍	振动觉减退,双下肢震动觉障碍,双下肢障碍
双侧中小量胸腔积液	胸腔积液中小量,胸腔积液
双侧声带外展受限	声带外展受限
双侧拇指强烈内收	拇指内收
双侧眼睑下垂	眼睑下垂
双侧瞳孔散大	瞳孔散大,瞳孔放大
双侧视乳头水肿	视乳头水肿
双侧针尖样瞳孔	瞳孔针尖样
双侧附件增厚呈条索状或形成炎性包块	附件条索状,附件包块,附件形成,附件增厚
双侧面瘫	面瘫
双侧面神经麻痹	面神经麻痹
双合诊盆腔触痛	盆腔压痛
双峰热	双峰热
双手僵硬	双手僵硬
双手动作笨拙	双手动作笨拙,双手笨拙,动作迟缓,动作笨拙
双手呈鹰爪形	双手鹰爪形
双手笨拙	双手笨拙
双手精细动作笨拙	双手笨拙,双手精细动作笨拙
双手震颤	双手震颤
双手颤抖	手抖,双手颤抖
双手鹰爪形	双手鹰爪形
双目凝视	双目凝视,凝视
双目失明	双目失明
双眼凝视	双眼凝视,凝视
双眼向一侧倾斜	双眼向一侧倾斜
双眼向下凝视	凝视,双眼凝视
双眼向病变同侧同向运动不能	双眼运动不能,双眼同向,双眼病变
双眼向病灶侧凝视麻痹	双眼向病灶侧凝视麻痹
双眼球下旋	双眼球下旋
双眼球向病灶对侧同向凝视不能	双眼球同向,凝视,双眼球不能
双眼视力障碍发作	视力障碍,双眼障碍,视力发作,双眼发作
双肺呼吸音减低	双肺呼吸音减低
双肺呼吸音增粗	双肺呼吸音增粗,双肺呼吸音粗
双肺呼吸音消失	双肺呼吸音消失
双肺哮鸣音	双肺哮鸣音,喘鸣音,哮鸣音
双肺均匀分布的薄壁囊肿	肺薄壁囊肿,薄壁囊肿
双肺干性啰音	双肺干啰音,干性啰音,双肺干性啰音
双肺底湿啰音	湿啰音,双肺底湿啰音,感染,肺部啰音
双肺弥漫斑片影	双肺阴影
双肺湿啰音	感染,肺部啰音,双肺湿啰音
双肺湿性啰音	双肺湿啰音,湿啰音,双肺湿性啰音,肺部啰音
双腿发紧	双腿发紧
双腿发育落后	发育障碍,双腿发育落后,双腿落后
双腿变细	双腿变细
双臂不能上举	双臂不能上举
双臂难以上举	双臂难以上举
双足下垂	足下垂
双足呈强直性伸展	双足伸展
双足踩棉感	双足踩棉感
双足踩棉花感	双足踩棉花感
双额部疼痛	双额部疼痛
双颧颊部蝶形红斑	双颧颊部红斑
反复低血糖	低血糖
反复便秘	便秘
反复发作上腹部疼痛	腹痛,上腹复发
反复发作四肢瘫痪	瘫,四肢复发,瘫痪
反复发作的大关节游走性关节炎	关节炎,大关节复发
反复发作的慢性膀胱刺激症状	膀胱刺激征,膀胱刺激症状
反复发作的肌无力	肌无力,四肢无力
反复发作的腹痛	腹痛
反复发作的腹部疼痛	腹痛,腹部复发,腹部疼痛
反复发作的高血压	高血压
反复发作肘关节外侧疼痛	肘关节痛,肘关节疼痛,肘关节复发
反复发作脐周疼痛	脐周疼痛,脐周痛,脐周复发
反复发热	发热
反复发生呼吸道感染	呼吸道感染
反复发生泌尿系感染	泌尿系感染
反复发生肾结石	肾结石
反复口腔溃疡	口腔溃疡
反复右下腹不适	腹不适
反复右下腹疼痛	腹痛,腹疼
反复呕吐	呕吐
反复呼吸道感染	呼吸道感染
反复呼吸道感染史	呼吸道感染
反复外阴溃疡	外阴溃疡
反复密集发作性头痛	头痛
反复尿路感染	尿路感染
反复心衰	心衰
反复急性发作阑尾炎	阑尾炎
反复感染	感染
反复无痛性血尿	血尿
反复晕厥	晕厥
反复消化道感染史	消化道感染,感染
反复牙龈出血	牙龈出血
反复癫痫发作	癫痫,癫痫发作
反复肺部感染	肺部感染,两肺感染灶
反复脓肿	脓肿
反复腹泻	腹泻
反复腹痛	腹痛
反复贾第鞭毛虫感染	感染
反复跌倒	跌倒
反复酮症	酮症,尿酮体阳性
反复酮症酸中毒	酮症酸中毒
反复阴道感染	感染
反复黏液血便	血便
反射亢进	反射亢进
反射性呕吐	呕吐
反射性咳嗽	咳嗽
反射性排尿	反射性排尿
反射性膀胱	反射性膀胱
反应低下	反应差,反应迟钝,反应低下
反应差	反应差
反应淡漠	情感障碍,淡漠,反应淡漠
反应能力下降	反应能力下降
反应迟钝	反应迟钝
反肺水肿征	肺水肿,肺气肿
反胃	反胃
反跳痛	反跳痛,痛
反跳痛明显	反跳痛明显,反跳痛,痛
反跳痛（Blumberg征）	痛,反跳痛
反酸	反酸
反食	反食
发作后清醒	清醒
发作性单侧眶周疼痛	眶周疼痛
发作性咳嗽	咳嗽
发作性头晕	头晕
发作性室速呈左束支阻滞图形	室速,左束支阻滞,室性心动过速
发作性搏动性偏头痛	偏头痛,头痛
发作性晕厥	晕厥
发作性的心慌、出汗、乏力	心慌,出汗,心悸,乏力
发作性眩晕	眩晕
发作性胸痛	胸痛
发作性胸闷	胸闷
发作性身体局部不自知抽动	身体抽动
发作间期肌力正常	肌力发作
发凉	发冷,发凉
发声困难	发声困难,发声障碍
发声抽动	发声抽动
发声无力	发声无力,无力
发声时声门间有小裂隙	发声小裂隙
发声疲倦感	疲惫,疲倦
发声疲劳	发声疲劳,疲惫,疲劳
发声障碍	发声障碍
发热	发热
发热24小时内皮疹	发热,皮疹
发热3-4天后出疹	出疹,发热
发状线	发状线
发绀	发绀
发育不良	发育障碍,发育不良
发育迟滞	发育障碍,发育迟滞
发育迟缓	发育迟缓,发育障碍
发际低	发际低
发音不清	发音不清
发音含糊不清	发声障碍,发音含糊不清
发音困难	发声障碍,发音困难
发音缓慢	发音缓慢
发音障碍	发声障碍,发音障碍
受伤部位疼痛	部位受伤,部位疼痛
受凉后活动障碍加重	活动障碍,活动加重
受凉后胸痛	胸痛
受孕功能降低	受孕功能降低
受累关节滑膜液嗜酸性粒细胞含量升高	关节受累,关节升高,嗜酸性粒细胞升高,关节增高,嗜酸性粒细胞增多,嗜酸性粒细胞增高,嗜酸性粒细胞受累
受累关节滑膜液检出伯氏疏螺旋体	关节受累
受累关节滑膜液蛋白含量升高	关节受累,关节升高,关节增高
受累腱鞘压痛	腱鞘受累,腱鞘压痛
变位性听力改善	听力改善
变应性鼻炎	变应性鼻炎
变换体位时疼痛加重	体位加重,体位疼痛
口中金属味	口中金属味
口吃	口吃
口吐白沫	口吐白沫
口周刺痛	口周刺痛
口周发绀	口周发绀,发绀
口周有皱褶	口周皱褶
口周苍白圈	口周苍白圈
口周麻木	口周麻木
口咽部黏膜充血	口咽部黏膜充血,黏膜充血
口咽部黏膜肿胀	口咽部黏膜肿胀,黏膜肿胀
口唇单纯疱疹	单纯疱疹,口唇单纯疱疹
口唇发绀	发绀,口唇发绀
口唇外翻	口唇外翻
口唇干裂	口唇干裂,唇裂
口唇糜烂	口唇糜烂
口唇色淡	口唇色淡
口唇苍白	皮肤苍白,口唇苍白,贫血
口唇青紫	口唇发紫,口唇青紫
口唇麻木	口唇麻木
口唇黏膜呈樱桃红色	口唇樱桃红色,黏膜樱桃红色
口唇黏膜苍白	贫血,皮肤苍白,口唇黏膜苍白,口唇苍白,黏膜苍白
口干	口渴,口干
口底组织压痛	口底组织压痛
口底组织波动感	口底组织波动感
口渴	口渴
口渴多饮	多饮,烦渴,口渴
口腔有尿味	口腔有尿味
口腔水疱	口腔水疱,水疱
口腔溃疡	口腔溃疡
口腔炎	口腔炎
口腔烧灼痛	口腔烧灼痛
口腔疱疹	口腔疱疹
口腔痛	口腔痛
口腔痛性溃疡	口腔溃疡
口腔白色斑膜	口腔斑膜,口腔白色
口腔粘膜干燥	口腔粘膜干燥
口腔粘膜斑丘疹	斑丘疹,丘疹,口腔粘膜斑丘疹
口腔粘膜疱疹	口腔粘膜疱疹,疱疹
口腔粘膜萎缩	口腔粘膜萎缩
口腔肿物	口腔肿物
口腔麻疹黏膜斑	koplik斑,麻疹黏膜斑,口腔麻疹黏膜斑
口腔黏膜充血	口腔黏膜充血
口腔黏膜有血泡	口腔黏膜血泡,血泡
口腔黏膜溃烂	口腔黏膜溃烂
口腔黏膜溃疡	口腔黏膜溃疡
口腔黏膜灼伤	口腔黏膜灼伤
口腔黏膜糜烂	口腔黏膜糜烂
口腔黏膜表面白色乳凝块样物	表面白色,口腔黏膜白色
口臭	口臭
口角下垂	口角下垂
口角下缩	口角下缩
口角歪斜	口角歪斜
口角疱疹	口角疱疹,疱疹
口角皲裂	口角皲裂
口角肌肉抽搐	口角抽搐,肌肉抽搐
口角面颊部轻触可诱发疼痛	面颊部疼痛,面颊痛,口角疼痛
口轮匝肌假性肥大	轮匝肌肥大,口肥大
口部过度活动	口部过度活动
口齿不清	口齿不清,构音障碍,吐字不清
叩击性肌强直	肌强直,肌肉强直
叩诊过清音	叩诊过清音,过清音
叩诊锤叩击四肢肌肉可见肌球	肌肉可见肌球,叩诊可见肌球,四肢可见肌球
可扪及肿大胆囊且有触痛	胆囊触痛,胆囊肿大,胆囊扪及
可有皮肤水疱	水疱,皮肤水疱
可触及右上腹肿物	腹肿块,腹包块,腹触及
可触及条索状痉挛的肠管	痉挛
可触及肿大的胆囊	胆囊触及,胆囊肿大
可逆的视觉障碍	视觉障碍
可闻及第三或第四心音	第四心音
右上腹不适	腹不适
右上腹包块	腹包块
右上腹压痛	腹部压痛
右上腹局部明显触痛	腹明显,腹部压痛
右上腹疼痛	腹痛,腹疼
右上腹痛	腹痛
右上腹绞痛	腹痛
右上腹绞痛后出现消化道出血	消化道出血,腹出现,腹痛
右上腹肌紧张	腹肌紧张
右上腹肌紧张及反跳痛	腹部压痛,痛,腹肌紧张,反跳痛
右上腹肿块	腹包块,腹肿块
右上腹轻度不适	腹不适
右上腹隐痛	腹痛
右下胸叩击痛	右下胸叩击痛
右下腹压痛	腹部压痛
右下腹反跳痛	腹部压痛,反跳痛,痛
右下腹固定压痛	腹固定压痛
右下腹痛	腹痛
右下腹肌紧张	腹肌紧张
右下腹肌紧张及反跳痛	腹肌紧张,反跳痛,腹部压痛,痛
右下腹肿块	腹包块,腹肿块
右侧半身浅感觉障碍	浅感觉障碍
右侧腰痛	腰痛
右季肋呈饱满状态	季肋饱满
右室肥厚	右室肥厚
右心室压力增高	右心室压力增高
右心室增大	右心室扩大,右心增大,右心室增大
右心室扩大	右心室扩大,右心增大
右心室肥厚	心室肥厚,右心室肥厚
右心房增大	右心房增大,右心房扩大
右心衰竭	右心衰竭
右房增大	右心房扩大,右房增大
右束支传导阻滞	右束支传导阻滞
右肩痛	右肩痛
右胸导联（V1～V3）ST段抬高	ST段抬高
右胸痛	右胸痛
吃奶呛咳	吃奶呛咳,呛咳
吃奶差	吃奶差,拒食
合并畸形产生的症状	症状畸形
吉兰-巴雷综合征	吉兰-巴雷综合征
同侧动眼神经麻痹	动眼神经麻痹
同侧周围性面瘫	面瘫
同侧展神经麻痹	展神经麻痹
同侧结膜充血	结膜充血,眼结膜充血
同侧膈肌麻痹	膈肌麻痹
同侧面神经麻痹	面神经麻痹
同向性偏盲	偏盲
后发际低	发际低
后囟在耻骨联合前	后囟
后囟在耻骨联合后	后囟
后囟大	后囟大
后背剧烈疼痛	背痛
后颈疼痛	后颈疼痛,颈痛
后颈部疼痛	后颈疼痛,颈痛
吐出蛔虫	吐出蛔虫
吐奶	呕吐,吐奶
吐字不清	构音障碍,吐字不清
向心性肥胖	向心性肥胖
向病灶对侧凝视麻痹	凝视,凝视麻痹
吞咽不适	吞咽不畅,吞咽不适,吞咽困难
吞咽困难	吞咽困难
吞咽异物感	异物感,吞咽异物感
吞咽时颈部疼痛加重	颈痛,颈部加重,颈部疼痛
吞咽梗噎感	吞咽梗噎感
吞咽疼痛	吞咽疼痛,吞咽痛
吞咽痛	吞咽痛
吞咽肌不受累	吞咽肌不受累
吞咽肌麻痹	吞咽肌麻痹,肌麻痹
吞咽障碍	吞咽不畅,吞咽困难,吞咽障碍
吟诗样语言	吟诗样语言
含服硝酸甘油后胸痛缓解不明显	胸痛
含服硝酸甘油胸痛缓解	胸痛,含服硝酸甘油缓解
含胆汁呕吐物	呕吐物含胆汁
含铁血黄素尿	尿含铁血黄素
听力下降	听觉减退,听力下降
听力丧失	听力丧失
听力减退	听力减退,听觉减退
听力波动性下降	听觉减退,听力下降
听力障碍	听力障碍
听幻觉	听幻觉
听觉过敏	听觉过敏
吸允时呼吸困难加重	气促,呼吸困难加重,呼吸困难
吸入性肺炎	肺炎
吸入胃内容物后咳嗽	咳嗽
吸吮力弱	吸吮无力,吸吮力弱
吸吮困难	吸吮困难
吸吮无力	吸吮无力
吸收不良综合征	吸收不良综合征
吸气喉鸣声	吸气喉鸣声
吸气性三凹征阳性	三凹征阳性,三凹征
吸气性呼吸困难	呼吸困难,气促
吸气性喉鸣	吸气性喉鸣
吸气性喘鸣	喘鸣,喘鸣音
吹口哨困难	吹口哨困难
吹口哨漏气	吹口哨漏气
呃逆	呃逆
呃逆少见	呃逆
呆滞	呆滞
呆视	呆视
呓语	呓语
呕吐	呕吐
呕吐出蛔虫	吐出蛔虫
呕吐后头痛缓解	头痛
呕吐后腹痛减轻	腹痛
呕吐咖啡样内容物	呕吐
呕吐宿食	呕吐
呕吐物为含胆汁的胃内容物	呕吐物含胆汁,呕吐物为胃内容物
呕吐物为胃内容物	呕吐物为胃内容物
呕吐物含有胆汁	呕吐物含胆汁,呕吐物含有胆汁
呕吐物含胆汁	呕吐物含胆汁
呕吐物大蒜味	呕吐物大蒜味
呕吐物有腐败酸臭味	呕吐物臭味
呕吐物潜血试验阳性	便潜血
呕吐米泔水样液体	呕吐
呕吐粪样液体	呕吐,呕吐粪样液体
呕吐胃内容物	呕吐,呕吐胃内容物
呕吐胆汁	呕吐
呕吐胆汁样物	呕吐
呕吐酸臭宿食	呕吐,呕吐酸臭宿食
呕吐随体位变化	呕吐
呕吐黄色液体	呕吐,呕吐黄色液体
呕血	呕血,出血倾向
呛咳	呛咳
周围性面瘫	面瘫
周围神经炎	周围神经炎
周围神经病	周围神经病
周围神经病变	周围神经病
周围神经症状	周围神经症状
周围神经麻痹	周围神经麻痹
周围血液嗜酸性粒细胞增多	血液增多,嗜酸性粒细胞升高,嗜酸性粒细胞增多,嗜酸性粒细胞增高
周围血管征阳性	周围血管征阳性
周围血管征阳性（水冲脉、枪击音、毛细血管搏动征、Duroziez双重音））	毛细血管搏动,水冲脉
周期性低钾性麻痹	周期性低钾性麻痹
周期性便血	便血
周期性发作寒战	寒战
周期性发热	发热
周期性发热（Pel-Ebstein热）	发热
周期性呕吐	呕吐,周期性呕吐
周期性瘫痪	瘫痪,瘫
周期性腹股沟淋巴结肿大疼痛	淋巴结疼痛,腹股沟肿物,淋巴结肿大,腹股沟淋巴结疼痛,腹股沟淋巴结肿大,腹股沟疼痛
周期性腹部淋巴结肿大疼痛	腹肿块,腹部淋巴结肿大,淋巴结疼痛,腹痛,淋巴结肿大,腹包块
周期性高热	高热,发热
周身不适	周身不适
周边视野缺损	视野缺损
味觉减退	味觉减退,味觉障碍
味觉异常	味觉异常
味觉迟钝	味觉障碍,味觉迟钝
味觉降低	味觉降低,味觉障碍,味觉减退
味觉障碍	味觉障碍
呻吟	呻吟
呼之不应	呼之不应
呼出气有苦杏仁味	呼出气苦杏仁味
呼出气有苯酚味	呼出气苯酚味
呼出气有蒜味	呼出气蒜味
呼出气有酒味	呼出气酒味
呼吸不均	呼吸不均
呼吸不畅	呼吸困难,气促,呼吸不畅
呼吸不规则	呼吸不规则
呼吸停止	呼吸停止
呼吸功能障碍	呼吸功能障碍
呼吸加快	呼吸困难,呼吸增快,呼吸加快,呼吸频率增快,气促
呼吸加深加快	呼吸困难,气促,呼吸加深,呼吸增快,呼吸加快,呼吸频率增快
呼吸加速	呼吸困难,气促,呼吸加速,呼吸频率增快
呼吸变浅	呼吸变浅
呼吸吹哨声	呼吸吹哨声
呼吸困难	呼吸困难,气促
呼吸困难可自行缓解	气促,呼吸困难
呼吸增快	呼吸增快,呼吸加快,气促,呼吸频率增快,呼吸困难
呼吸幅度不均	呼吸幅度不均
呼吸异常	呼吸异常
呼吸快速	呼吸频率增快,呼吸困难,呼吸快速,气促
呼吸急促	气促,呼吸急促,呼吸频率增快,呼吸困难
呼吸性碱中毒	呼吸性碱中毒
呼吸慢	呼吸缓慢,呼吸慢
呼吸抑制	呼吸抑制
呼吸暂停	呼吸暂停,呼吸停顿
呼吸有鼾音	呼吸有鼾音
呼吸浅快	呼吸浅快
呼吸浅慢	呼吸缓慢,呼吸浅慢
呼吸浅而快	呼吸浅快,呼吸快,气促
呼吸浅速	呼吸浅速,呼吸缓慢
呼吸深快	呼吸困难,呼吸深快
呼吸深长	呼吸深长
呼吸紊乱	呼吸紊乱
呼吸缓慢	呼吸缓慢
呼吸肌无力	呼吸肌无力,无力
呼吸肌麻痹	呼吸肌麻痹
呼吸节律不整	呼吸节律不整,呼吸节律不齐
呼吸节律不规则	呼吸节律不规则,呼吸不规则
呼吸节律改变	呼吸节律改变
呼吸表浅	呼吸表浅
呼吸衰竭	呼吸衰竭
呼吸衰竭表现	呼吸衰竭,呼吸衰竭表现
呼吸费力	呼吸困难,气促,呼吸费力
呼吸运动减弱	呼吸运动减弱
呼吸道合胞病毒阳性	呼吸道合胞病毒阳性
呼吸道感染	呼吸道感染
呼吸道感染后加重血尿	血尿,呼吸道感染
呼吸音减低	呼吸音低,呼吸音减低
呼吸音减弱	呼吸音减弱,呼吸音低
呼吸音消失	呼吸音消失,呼吸音低
呼吸音粗糙	双肺呼吸音粗,双肺音粗,呼吸音粗糙
呼吸音降低	呼吸音低,呼吸音降低
呼吸频率增快	呼吸频率增快,呼吸频率增加,气促
呼吸频率快	呼吸频率快,气促
呼吸骤停	呼吸停顿,呼吸骤停
呼吸麻痹	呼吸麻痹
呼气中有烂苹果味	呼气烂苹果味
呼气呻吟	呻吟,呼气呻吟
呼气延长	呼气延长
呼气性呼吸困难	呼吸困难,气促
呼气性哮鸣音	哮鸣音,喘鸣音
呼气有苦杏仁味	呼气苦杏仁味
呼气烂苹果味	呼气烂苹果味
呼气相延长	呼气相延长
命名性失语	失语
咀嚼无力	咀嚼无力,无力
咀嚼时下颌关节疼痛	关节疼痛,关节痛
咀嚼时面颊部肌肉疼痛	肌肉痛,面颊痛,肌肉疼痛,咀嚼疼痛,肌痛
咀嚼肌压痛	咀嚼肌压痛
咀嚼肌无力	咀嚼肌无力,无力
咀嚼障碍	咀嚼障碍
咬合困难	咬合困难
咬合无力	咬合无力,无力
咬字不清	咬字不清
咯咯声响	咯咯声响
咯白色泡沫样痰	泡沫痰
咯血	咯血,咳血痰
咳出头发样细毛	细毛头发样
咳出管形假膜	假膜
咳嗽	咳嗽
咳嗽加重	咳嗽,咳嗽加重
咳嗽或久站后出现腹股沟韧带下方半球形突起	腹股沟出现,韧带出现,腹股沟半球形,咳嗽,腹股沟突起,韧带半球形,韧带突起
咳嗽无力	咳嗽无力
咳嗽时头痛加重	头痛
咳嗽时腹痛加重	腹痛
咳嗽时腹部肿物无冲击感	腹部无冲击感,腹肿块,腹部肿物
咳嗽时腹部肿物有冲击感	腹部冲击感,腹肿块,腹部肿物
咳嗽疼痛加重	咳嗽,咳嗽加重
咳坏死组织	咳,咳坏死组织
咳大量血痰	咳,血痰,咳血痰
咳果酱样血痰	咳血痰,咳,血痰
咳棕黄色脓痰	咳棕黄色脓痰,咳痰
咳泡沫痰	咳,泡沫痰
咳浆液性泡沫痰	泡沫痰,咳
咳痰	咳痰
咳白色浆液性泡沫痰	泡沫痰,咳
咳粉红色泡沫痰	咳粉红色泡沫痰,咳痰
咳粘液脓痰	咳,脓痰,咳痰
咳脓痰	咳痰,咳脓痰,脓痰
咳血	咳血
咳血痰	咳血痰
咳铁锈色痰	咳,痰铁锈色
咽下困难	咽下困难
咽下疼痛	咽下困难,咽下疼痛
咽侧壁充血	咽侧壁充血
咽侧壁圆形囊肿	咽侧壁囊肿,咽侧壁圆形
咽侧壁易出血肿块	咽侧壁易出血肿块
咽侧壁隆起	咽侧壁隆起
咽内不适	咽内不适
咽及扁桃体灰白色疱疹及浅表溃疡	扁桃体灰白色,扁桃体溃疡,疱疹
咽反射减弱	咽反射减弱
咽反射消失	咽反射消失
咽后壁圆形囊肿	咽后壁圆形,咽后壁囊肿
咽后壁增厚外突	咽后壁增厚,咽后壁外突
咽后壁易出血肿块	咽后壁易出血肿块
咽后壁淋巴滤泡隆起	淋巴隆起,咽后壁隆起
咽后壁隆起	咽后壁隆起
咽后壁黏膜充血	咽后壁充血,咽后壁黏膜充血,黏膜充血
咽喉不适	咽喉不适
咽喉异常感	咽喉异常
咽喉异物感	咽喉异物感,异物感
咽喉疼痛	咽痛,咽喉疼痛,咽喉痛
咽喉肌萎缩	咽喉肌萎缩,肌萎缩
咽喉部感觉障碍	咽喉部障碍,咽喉部感觉障碍,感觉障碍
咽喉部粘膜白斑	粘膜白斑,咽喉部粘膜白斑,咽喉部白斑
咽喉阻塞感	咽喉阻塞感
咽干	咽干
咽异感症	咽异感症
咽拭子培养A组链球菌阳性	咽拭子培养链球菌阳性
咽拭子培养链球菌阳性	咽拭子培养链球菌阳性
咽痒	咽痒
咽痛	咽痛
咽痛向牙齿放射	咽痛,牙齿放射
咽痛向耳部放射	咽痛,耳部放射
咽红	咽红
咽结膜充血	结膜充血,咽充血,咽结膜充血,咽红,咽部充血,眼结膜充血
咽腭弓圆柱状	咽腭弓圆柱状
咽腭弓红肿	咽腭弓红肿
咽部不适	咽部不适,咽喉不适
咽部不适感	咽部不适感
咽部充血	咽部充血,咽充血
咽部干燥	咽部干燥
咽部异物感	咽部异物
咽部灰白色假膜	咽部灰白色,假膜,咽部假膜
咽部灼热	咽部灼热
咽部烧灼感	咽部烧灼感
咽部疱疹	疱疹,咽部疱疹
咽部白膜	咽部白膜
咽部粘膜溃疡伴脓性假膜	假膜,粘膜溃疡,咽部起疱
咽部肌肉无力	无力,四肢无力,肌肉无力
咽部阻塞感	咽部阻塞感
咽部黏膜出血	咽部出血,黏膜出血
咽隐窝小结节状隆起	咽隐窝隆起,咽隐窝小结节
咽隐窝肉芽肿性隆起	咽隐窝隆起
咽隐窝饱满	咽隐窝饱满
咽隐窝黏膜下隆起	黏膜隆起,咽隐窝隆起
咽黏膜充血	咽黏膜充血
咽黏膜增厚	咽黏膜增厚
咽黏膜肿胀	咽黏膜肿胀
咽黏膜苍白	咽黏膜苍白
哈欠	哈欠
哈钦森三联征	哈钦森三联征
哭声低且小	哭声小
哭声低弱	哭声低弱
哭声小	哭声小
哭声异常	哭声异常
哭声弱	哭声弱
哭时无泪	哭时无泪
哭闹	哭闹
哭闹不安	哭闹,不安
哭闹时呼吸困难加重	呼吸困难,气促,呼吸困难加重
哮喘	哮喘
哮喘发作	哮喘
哮鸣音	喘鸣音,哮鸣音
唇充血皲裂	唇充血,唇皲裂
唇厚舌大	唇厚舌大
唇干	唇干
唇干裂	唇干裂,唇裂
唇肌萎缩	唇肌萎缩,肌萎缩
唇肥厚	唇肥厚,唇厚
唇舌干燥	唇舌干燥
唇裂	唇裂
唾液分泌增加	唾液分泌增加,唾液分泌增多
唾液分泌增多	分泌增多,唾液分泌增多
啼哭	啼哭
啼哭时脐部肿块突出	脐部突出,脐部肿块,啼哭
喂养困难	喂养困难
喉咙痒	喉咙痒
喉喘鸣	喉喘鸣
喉室红色隆起	喉室红色,喉室隆起
喉室黄色隆起	喉室黄色,喉室隆起
喉痉挛	喉痉挛
喉痒	喉痒
喉痛	喉痛
喉粘膜充血	粘膜充血,喉粘膜充血,喉充血
喉粘膜增生肥厚	粘膜肥厚,喉增生,粘膜增生,喉肥厚
喉结增大	喉结增大
喉肌萎缩	肌萎缩,喉肌萎缩
喉部不适	喉部不适
喉部乳头状瘤	喉部乳头状,乳头状瘤,喉部瘤
喉部刺痛	喉部刺痛,喉痛
喉部囊肿	喉部囊肿
喉部圆形肿瘤	喉部圆形,肿瘤
喉部带状瘢痕组织	瘢痕组织带状,喉部带状瘢痕组织,喉部带状
喉部干燥	喉部干燥
喉部干燥感	喉部干燥感
喉部异物	喉部异物
喉部异物感	喉部异物
喉部灰白色假膜	假膜,喉部灰白色
喉部烧灼感	喉部烧灼感
喉部环状瘢痕组织	喉部环状,瘢痕组织环状,喉部环状瘢痕组织
喉部疼痛	喉痛,喉部疼痛
喉部肿块	喉部肿块
喉部黏膜下出血	喉部出血,黏膜出血
喉部黏膜充血	黏膜充血,喉部黏膜充血,喉部充血
喉部黏膜肿胀	喉部黏膜肿胀,黏膜肿胀,喉部肿胀
喉镜检查无异常	喉镜检查无异常
喉阻塞	喉阻塞
喉阻塞一度	喉阻塞,喉阻塞一度
喉阻塞三度	喉阻塞三度,喉阻塞
喉阻塞二度	喉阻塞二度,喉阻塞
喉阻塞四度	喉阻塞四度,喉阻塞
喉黏膜充血	喉黏膜充血
喉黏膜发亮	喉黏膜发亮
喉黏膜变薄	喉黏膜变薄
喉黏膜干燥	喉黏膜干燥
喉黏膜弥漫性水肿	喉黏膜水肿
喉黏膜斑块	喉黏膜斑块
喉黏膜斑片状突起	喉黏膜突起
喉黏膜水肿	喉黏膜水肿
喉黏膜深红色水肿	喉黏膜深红色,喉黏膜水肿
喉黏膜溃疡	喉黏膜溃疡
喉黏膜肿胀	喉黏膜肿胀
喉黏膜苍白	喉黏膜苍白
喉黏膜表面痂皮	喉黏膜痂皮,喉黏膜表面痂皮,表面痂皮
喉黏膜表面白色锥形突起	表面突起,喉黏膜表面白色锥形,喉黏膜突起,喉黏膜白色锥形,表面白色锥形
喘息	呼吸困难,气喘,喘息,憋喘
喘憋	憋喘,喘憋
喘鸣	喘鸣音,喘鸣
喘鸣音	喘鸣音
喜冷饮	喜冷饮
喝冷饮后胸痛	胸痛
喷嚏	喷嚏
喷嚏疼痛加重	喷嚏
喷射性呕吐	呕吐
喷射性收缩期杂音	心尖区收缩期杂音,心脏杂音,收缩期杂音
喷射样呕吐	呕吐
喷射状呕吐	呕吐
嗅幻觉	嗅幻觉
嗅沟饱满	嗅沟饱满
嗅觉丧失	嗅觉丧失,嗅觉障碍
嗅觉减退	嗅觉减退,嗅觉障碍
嗅觉异常	嗅觉障碍,嗅觉异常
嗅觉缺失	嗅觉缺失
嗅觉降低	嗅觉降低,嗅觉障碍,嗅觉减退
嗅觉障碍	嗅觉障碍
嗜咸食	嗜咸食
嗜睡	意识不清,嗜睡
嗜酸性粒细胞减少	嗜酸性粒细胞减少
嗜酸性粒细胞增多	嗜酸性粒细胞升高,嗜酸性粒细胞增多,嗜酸性粒细胞增高
嗜酸性粒细胞增高	嗜酸性粒细胞增高,嗜酸性粒细胞升高,嗜酸性粒细胞增多
嗜酸性粒细胞消失	嗜酸性粒细胞消失
嗜酸性粒细胞百分比减少	百分比减少,嗜酸性粒细胞百分比减少,嗜酸性粒细胞减少
嗳气	嗳气
嘴唇内收	嘴唇内收
嘴唇发绀	嘴唇发绀,发绀
嘴唇变薄	嘴唇变薄
嘴唇增厚	嘴唇增厚
嘴唇微翘	嘴唇微翘
囊肿压迫症状	囊肿压迫症状
囊肿穿刺抽出乳白色液体	穿刺乳白色,穿刺囊肿
囊肿穿刺抽出气体	穿刺囊肿
囊肿穿刺抽出褐色液体	穿刺褐色,穿刺囊肿
四凹征	四凹征
四肢乏力	四肢乏力,乏力
四肢共济失调	共济失调,四肢共济失调
四肢冰冷	发冷,四肢冷,四肢冰冷
四肢冰凉	四肢冷,发冷,四肢冰凉
四肢冷	发冷,四肢冷
四肢厥冷	四肢厥冷,四肢冷,发冷,四肢湿冷
四肢及腰背部酸痛	四肢酸痛,四肢疼痛,腰背痛
四肢发冷	四肢发冷,发冷
四肢发凉	四肢发凉,四肢冷,发冷
四肢发凉震颤	四肢震颤,发冷,四肢发凉,四肢冷
四肢对称分布出血点	四肢对称,四肢出血点
四肢张力下降	四肢张力下降,四肢下降
四肢感觉障碍	感觉障碍,四肢感觉障碍,四肢障碍
四肢手套样感觉异常	四肢感觉异常
四肢无力	无力,四肢无力
四肢末端皮肤发红	皮肤发红,四肢发红,皮肤红
四肢末端皮肤发绀	皮肤发绀,发绀
四肢末端皮肤苍白	四肢苍白,皮肤苍白
四肢末端麻木	肢体麻木,四肢麻痹,四肢麻木
四肢活动障碍	四肢活动障碍,四肢障碍,活动障碍
四肢淋巴结疼痛	四肢淋巴结疼痛,淋巴结疼痛,四肢疼痛
四肢温度下降	四肢温度下降,四肢下降,温度下降
四肢温暖	四肢温暖
四肢湿冷	四肢冷,四肢湿冷,发冷
四肢疼痛	四肢疼痛
四肢瘦	四肢瘦
四肢瘫	四肢瘫
四肢瘫痪	瘫痪,瘫
四肢皮疹少	皮疹,四肢少
四肢皮肤出血点	四肢皮肤出血点,四肢出血点,皮肤出血点
四肢皮肤逐渐变黑	皮肤变黑,皮肤发黑,四肢变黑
四肢肌力减退	四肢肌力减退
四肢肌张力增强	四肢肌张力增强
四肢肌萎缩	四肢肌萎缩,肌萎缩
四肢肿胀	四肢肿胀
四肢腱反射亢进	反射亢进,腱反射亢进
四肢腱反射减弱	腱反射减弱,四肢减弱,四肢腱反射减弱
四肢腱反射消失	四肢腱反射消失,四肢消失,腱反射消失
四肢袜套样感觉异常	四肢袜套样,四肢感觉异常
四肢轻瘫	四肢轻瘫
四肢运动感觉障碍	四肢障碍
四肢运动障碍	运动异常,四肢运动障碍,运动障碍
四肢近端无力	四肢无力
四肢远端感觉减退	四肢减退,感觉障碍,感觉减退
四肢远端肌无力	四肢无力,肌无力
四肢远端肌萎缩	四肢肌萎缩,肌萎缩
四肢远端麻木	四肢麻木,肢体麻木,四肢麻痹
四肢酸痛	四肢疼痛,四肢酸痛
四肢针刺样感觉异常	四肢感觉异常
四肢长	四肢长
四肢麻木	四肢麻痹,肢体麻木,四肢麻木
回归热	回归热
囟门膨隆	囟门膨隆
囟门隆起	囟门隆起
因十分用力而出现面部发红	面部发红,面部出现
因疼痛不敢刷牙	刷牙疼痛,刷牙不敢
因疼痛不敢洗脸	洗脸不敢,洗脸疼痛
因疼痛不敢进食	进食疼痛,进食不敢
困倦	困倦
困倦多睡	困倦
固执	固执
在锁骨上下区以及颈侧部可闻及粗糙的收缩期杂音	心脏杂音,收缩期杂音,颈侧部粗糙,锁骨粗糙,心尖区收缩期杂音
地图舌	地图舌
坏死性游走性红斑	红斑
坏死性蜂窝织炎	蜂窝织炎
坏死性血管炎	血管炎
坏疽	坏疽
坐下时健侧臀部先着力	臀部先着力
坐位困难	坐姿障碍,坐位困难
坐立不安	坐立不安
坐骨神经痛	坐骨神经痛
垂体CT示垂体占位性病变	垂体占位性病变
垂体MRI示垂体占位性病变	垂体占位性病变
垂体MRI示垂体瘤	垂体瘤
垂体功能亢进	垂体功能亢进
垂体功能减退	垂体功能减退
垂体肿瘤病史	垂体肿瘤
垂头	垂头
垂直凝视麻痹	垂直凝视麻痹
垂直性凝视麻痹	凝视,凝视麻痹
垂腕	垂腕
垂足	垂足
基础代谢率降低	基础代谢率降低
塌陷征	塌陷征
塔状头畸形	塔状头畸形
声光刺激加剧头痛	头痛
声嘶	嘶哑,声嘶
声带不能外展	声带不能外展
声带不能闭合	声带不能闭合
声带充血	声带充血
声带充血水肿	声带充血,声带水肿,声带肿胀
声带变形	声带变形
声带变红	声带变红
声带固定	声带固定
声带小结	声带小结
声带粗厚	声带粗厚
声带红色隆起	声带隆起,声带红色
声带结节状	声带结节
声带结节状隆起	声带结节
声带肥厚	声带肿胀,声带肥厚
声带肿物	声带肿物,声带肿胀
声带肿胀	声带肿胀
声带蹼状物	声带蹼状物
声带边缘变钝	声带变钝
声带边缘松弛	声带松弛
声带麻痹	声带麻痹
声带黄色隆起	声带黄色,声带隆起
声带黏脓性分泌物附着	声带分泌物附着
声时缩短	声时缩短
声门下区粘连	声门下区粘连
声门下红色隆起	声门下隆起,声门下红色
声门下黄色隆起	声门下黄色,声门下隆起
声门下黏膜向中间隆起	黏膜向中间隆起,声门下向中间隆起,声门下黏膜向中间隆起
声门不能完全闭合	声门不能完全闭合
声门不能打开	声门不能打开
声门变窄	声门变窄
声门可闭合	声门可闭合
声门闭合时梭状裂隙	声门闭合,声门裂隙
声门闭锁	声门闭锁
声音低哑	声音低沉,声音低哑
声音嘶哑	声音嘶哑,嘶哑
声音改变	声音改变
声音沙哑	声音沙哑,声门闭锁
复听	复听
复视	视力障碍,复视
夏科关节	夏科关节
外伤	外伤
外伤伤口渗血不止	出血不止,伤口不止,外伤
外伤后止血困难	止血困难
外周水肿	水肿
外周血嗜酸性粒细胞增多	嗜酸性粒细胞增高,嗜酸性粒细胞升高,嗜酸性粒细胞增多
外周血异型淋巴细胞>10%	淋巴细胞增多
外生殖器不适	外生殖器不适
外生殖器发育不全	外生殖器发育不全
外生殖器疼痛	外生殖器疼痛
外耳小	外耳小
外耳水疱	水疱,外耳水疱
外耳湿疹	外耳湿疹
外耳烧灼感	外耳烧灼感
外耳瘙痒	外耳瘙痒
外耳皮肤增厚	外耳皮肤增厚,皮肤增厚,外耳增厚
外耳皲裂	外耳皲裂
外耳粟粒状丘疹	外耳粟粒状,皮疹,外耳丘疹
外耳糜烂	外耳糜烂
外耳红斑	外耳红斑
外耳道后上骨壁塌陷	外耳道塌陷,骨壁塌陷
外耳道后上骨壁缺损	外耳道缺损,骨壁缺损
外耳道异物	外耳道异物
外耳道感觉减退	感觉减退,感觉障碍,外耳道减退,外耳道感觉减退
外耳道棕黑色块状物堵塞	外耳道块状物,外耳道棕黑,外耳道堵塞
外耳道流脓	外耳道流脓
外耳道狭窄	外耳道狭窄
外耳道疱疹	疱疹,外耳道疱疹
外耳道白色粉末状真菌	真菌白色,外耳道白色
外耳道白色胆脂瘤团块	胆脂瘤,外耳道白色
外耳道筒状痂皮	外耳道痂皮
外耳道绒毛状真菌	外耳道绒毛状真菌,外耳道绒毛状,真菌绒毛状
外耳道耵聍堵塞	外耳道堵塞,耵聍堵塞,外耳道耵聍堵塞
外耳道肿块	外耳道肿胀,外耳道肿块
外耳道肿胀	外耳道肿胀
外耳道胆脂瘤	胆脂瘤
外耳道黄色胆脂瘤样物	胆脂瘤,外耳道黄色
外耳道黄褐色块状物堵塞	外耳道块状物,外耳道黄褐色,外耳道堵塞
外耳黄水样分泌物	分泌物黄水样,外耳黄水样,外耳黄水样分泌物
外耳黄色痂皮	外耳痂皮,外耳黄色
外阴下坠感	外阴下坠感
外阴不规则乳头状瘤	外阴不规则,外阴瘤,外阴乳头状,乳头状瘤
外阴不适	外阴不适
外阴丘疹	皮疹,外阴丘疹
外阴乳头状赘疣	外阴赘疣,外阴乳头状
外阴出血	外阴出血
外阴地图样红斑	外阴地图样,外阴红斑
外阴坠胀	外阴坠胀
外阴多角形小丘疹	外阴丘疹,皮疹,外阴小
外阴夜间瘙痒	外阴瘙痒
外阴尖锐湿疣	外阴尖锐湿疣
外阴局部烧灼感	外阴局部烧灼感
外阴局部疼痛	外阴疼痛,外阴痛
外阴局部肿胀	外阴肿胀
外阴异物感	外阴不适,异物感,外阴异物感
外阴抓痕	外阴抓痕
外阴摩擦异物感	外阴不适,外阴异物感,异物感
外阴斑块	外阴斑块
外阴斑点	外阴斑点
外阴有抓痕	外阴有抓痕
外阴水肿	外阴肿胀,外阴水肿
外阴渗液	外阴渗液
外阴湿疹	外阴湿疹
外阴溃疡	外阴溃疡
外阴灼热	外阴灼热,外阴不适
外阴灼热不适	外阴灼热不适
外阴灼痛	外阴灼痛,外阴疼痛
外阴烧灼感	外阴灼痛,外阴烧灼感,外阴疼痛
外阴疼痛	外阴疼痛,外阴痛
外阴瘙痒	外阴瘙痒
外阴瘙痒难耐	外阴瘙痒
外阴白斑	外阴白斑
外阴白斑区瘙痒	外阴白斑
外阴白斑大小不等	外阴白斑
外阴白斑形态不一	外阴白斑
外阴白色斑片区	外阴斑片,外阴白色
外阴白色苔状物覆盖	外阴白色
外阴皮损呈灰白色	外阴灰白色,皮损
外阴皮肤丘疹融合后呈紫癜状	外阴皮肤丘疹,丘疹,外阴皮肤紫癜状,皮疹
外阴皮肤增厚	外阴皮肤增厚
外阴皮肤暗红	外阴皮肤暗红
外阴皮肤瘙痒	外阴皮肤瘙痒
外阴皮肤粗糙增厚	外阴皮肤增厚,外阴皮肤粗糙
外阴皮肤纹理明显	外阴皮肤纹理明显
外阴皮肤肿胀	外阴皮肤肿胀
外阴皮肤色素增加	外阴皮肤色素增加
外阴皮肤色素脱失	外阴脱失,外阴皮肤色素脱失,皮肤色素脱失
外阴皮肤苔癣样变	苔癣
外阴皮肤角化过度部位呈白色	角化过度,部位白色
外阴皮肤黏膜潮红	外阴潮红,外阴皮肤黏膜潮红
外阴皲裂	外阴皲裂
外阴糜烂	外阴糜烂
外阴红疹	红疹,外阴红疹
外阴结节	外阴肿物,外阴结节
外阴肿物	外阴肿胀,外阴肿物
外阴肿胀	外阴肿胀
外阴脱出肿物	外阴脱出肿物
外阴脱出肿物溃疡	外阴溃疡,外阴脱出肿物
外阴色素沉着	外阴色素沉着
外阴色素沉着范围增大	外阴色素沉着
外阴苔藓样变	苔藓样变,外阴苔藓样变
外阴萎缩	外阴萎缩
外阴表皮脱屑	脱屑,外阴表皮脱屑
外阴赘生物	外阴肿物,外阴赘生物
外阴较平时湿润	外阴湿润
外阴部囊肿	外阴部囊肿
外阴阴道假丝酵母菌感染反复发作	感染,假丝酵母菌,阴道复发,外阴复发
外阴阴道宫颈着色	宫颈着色
多关节炎	多关节炎
多关节酸痛	多关节酸痛
多动	多动
多动不安	多动,不安
多动障碍	多动障碍,多动性障碍,多动
多发性内分泌瘤病家族史	内分泌家族史,内分泌瘤
多发性出血倾向	出血倾向
多发性单神经炎	神经炎
多发性微小肌阵挛	肌阵挛
多发性脑叶出血	脑叶出血
多发性骨发育不良	发育不良,发育障碍
多发皮肤瘀斑	皮肤瘀斑,皮肤出血点
多发龋齿	龋齿
多器官损害	多器官损害
多尿	多尿,尿频
多形性皮损	皮损
多形性皮疹	皮疹
多形红斑	红斑
多梦	多梦
多次腹痛发作经排便后缓解	腹痛
多次腹痛发作经排气后缓解	排气发作,排气缓解,腹痛
多毛	多毛
多毛症	多毛,多毛症
多汗	多汗
多疑	多疑
多脏器衰竭	脏器衰竭,脏器多
多血质面容	面容多血质
多部位运动抽动	运动抽动
多食	多食
多食不明显	多食不明显,多食
多食善饥	多食
多食易饥	多食易饥,多食,易饥
多饮	多饮,烦渴
夜啼	夜啼
夜尿	夜尿
夜尿增多	夜尿增多,夜尿
夜尿多	夜尿多,夜尿
夜尿次数增加	夜尿次数增加
夜惊	睡眠差,睡眠障碍,夜惊
夜盲	视力差,夜盲
夜间关节痛	关节痛
夜间剧烈咳嗽	咳嗽
夜间反酸	反酸
夜间可发生误吸	误吸
夜间咳嗽	咳嗽
夜间多汗	多汗
夜间对称双下肢无力	无力,双下肢对称,双下肢无力
夜间尿频	尿频
夜间憋气	夜间憋气,夜间憋醒
夜间憋醒	夜间憋醒,呼吸困难
夜间盗汗	盗汗
夜间睡眠不安	睡眠不安
夜间磨牙	磨牙
夜间胸骨后痛	胸骨后痛,胸痛,胸骨后疼痛
夜间腹痛	腹痛
夜间视力差	视力差
夜间阵发性呼吸困难	气促,呼吸困难
大三阳	大三阳
大便不成形	大便不成形
大便变细	大便变细
大便后肛门滴血	肛门大
大便困难	大便障碍,大便困难
大便失禁	大便失禁
大便少	大便少
大便带血	大便带血
大便念珠菌阳性	真菌培养念珠菌生长
大便排出脓液	大便排出脓液
大便时头痛加重	头痛
大便次数减少	大便次数减少
大便次数增多	大便次数增多
大便次数多	大便次数多
大便表面带血	大便表面带血,大便带血,表面带血
大便频而量少	大便频而量少
大便颜色变浅	大便颜色变浅
大关节损害	大关节损害
大关节游走性痛	大关节痛,关节痛
大关节痛	关节痛,大关节痛
大咯血	咳血痰,咯血
大小便功能障碍	大小便功能障碍
大小便困难	大小便功能障碍,大小便困难
大小便失禁	大小便失禁
大拇指内收掌心	拇指内收
大汗	出汗,大汗
大汗淋漓	大汗,出汗,大汗淋漓
大汗淋漓后热退	大汗,出汗,大汗淋漓
大疱样皮损	皮损
大脑皮层刺激症状	大脑皮层刺激症状
大腿内侧淋巴管疼痛	淋巴管疼痛,腿痛
大腿内侧淋巴管肿胀	大腿肿胀,淋巴管肿胀
大腿内侧湿疹	湿疹
大腿前外侧下2/3区感觉异常	大腿感觉异常
大腿外侧感觉减退	感觉障碍,感觉减退,大腿减退
大腿外侧感觉消失	感觉消失,大腿消失,感觉障碍
大腿外侧感觉过敏	感觉过敏,感觉障碍,大腿过敏
大腿屈曲困难	大腿困难,大腿屈曲
大腿疼痛	大腿疼痛,腿痛
大腿蚁走感	大腿蚁走感,蚁走感
大腿麻木	大腿麻木
大量出汗	出汗
大量心包积液	心包积液
大量水样泻	腹泻
大量脂肪泻	脂泻,脂肪泻
大量蛋白尿	蛋白尿
大量阴道出血	阴道出血
大阴唇上部肿物	大阴唇肿物
大阴唇皮肤颜色变白	大阴唇皮肤颜色变白
大阴唇皲裂	大阴唇皲裂
大阴唇脱皮	脱皮,大阴唇脱皮
大阴唇部位红肿热痛	部位疼痛
大鱼际肌肉萎缩	肌萎缩,大鱼际萎缩,大鱼际肌肉萎缩,肌肉萎缩
天门冬氨酸氨基转移酶增高	谷草转氨酶升高
失声	失声
失明	失明
失水过多	失水过多
失用	失用
失眠	失眠
失神	失神
失算	失算
失血性休克	失血性休克
失认	失认
失语	失语
失语症	失语,失语症
失读	失读
头下垂征	头下垂征
头发变黄	头发变黄
头发稀少	头发稀少,头发少
头发纤细	头发纤细
头后仰	头后仰
头向一侧扭转/阵挛性倾斜	头倾斜,头扭转
头周紧箍感	头周压迫感,头周紧箍感
头围增大	头颅增大,头围增大
头围增长超过2cm/月	头围增长
头围增长过快	头围增长过快
头围扩大	头围扩大
头围迅速增大	头颅增大,头围增大
头大	头大
头昏	头昏
头晕	头晕
头晕可自行缓解	头晕
头晕呈阵发性	头晕
头晕头昏	头昏,头晕
头状骨远端背侧唇样骨质增生	骨质增生
头疼	头痛,头疼
头痛	头痛
头痛3个月	头痛
头痛与月经有明显关系	头痛
头痛呕吐	呕吐,头痛
头痛在晨醒时加重	头痛
头痛常在固定时间发作	头痛
头痛放射至颈后部	颈后放射,头痛
头痛进行性加重	头痛
头痛随体位变化	头痛
头皮/乳突周围静脉怒张	静脉怒张
头皮发际部皮疹	皮疹
头皮局部肿胀	头皮肿胀
头皮浅静脉扩张	浅静脉扩张,头皮浅静脉扩张,头皮扩张
头皮红斑	头皮红斑
头皮菲薄	头皮菲薄
头皮触痛	头皮触痛
头皮隆起	头皮隆起
头皮静脉怒张	头皮静脉怒张,静脉怒张
头胀	头胀
头转动时头晕加重	头转动,头晕,头加重
头部不自主同向转动	头部不自主同向转动
头部压迫感	头部压迫感
头部叩诊呈破壶音	叩诊破壶音,头部破壶音
头部形态异常	头部形态异常,头部异常,形态异常
头部持续性钝痛	头痛
头部杂音	头部杂音
头部歪斜	头部歪斜
头部红斑	头部红斑
头部震颤	头部震颤
头面部红斑	头面部红斑
头颅MRI示颅内占位性病变	颅内占位性病变
头颅与躯体生长比例不协调	生长不协调,躯体不协调,头颅不协调
头颅变大	头颅变大
头颅呈圆形	头颅呈圆形
头颅增大	头颅增大
头颅大	头颅大
头颅有向前下坠感	头颅下坠感
头颅畸形	头颅畸形
头颅短小	头颅短小
头颈倾斜	头颈倾斜
头颈偏斜	头颈偏斜
头颈及上肢出汗异常	出汗异常,头颈异常,上肢异常,出汗
头颈部扳紧感	头颈部扳紧感
头颈部旋转时眩晕	头颈部旋转,眩晕
头颈部活动不灵	头颈部活动不灵
夹层动脉瘤	夹层动脉瘤
夹纸试验阳性	夹纸试验阳性
奇痒难忍	奇痒,奇痒难忍
奇脉	奇脉
奔马律	奔马律,心脏杂音
女孩假两性畸形	假两性畸形
女孩幼稚型性征	幼稚型性征
女性假两性畸形	假两性畸形
女性男性化	女性男性化
女性青春期延迟	青春期延迟,女性青春期延迟
妄想	妄想
妊娠20周后出现高血压	高血压
妊娠20周后尿蛋白增多	尿蛋白增多,蛋白尿阳性,尿蛋白
妊娠24周前出现水肿	妊娠水肿
妊娠24周前出现蛋白尿	妊娠蛋白尿
妊娠24周前出现高血压	高血压
妊娠早期流产	早期流产,妊娠早期流产
妊娠期体重增加迅速	体重增加迅速
妊娠期自发性子宫破裂	子宫破裂
妊娠期血糖增高	血糖增高,高血糖
妊娠期黄疸	黄疸
始基子宫	始基子宫
姿势平衡障碍	姿势平衡障碍,姿势障碍,平衡障碍
姿势异常	姿势异常,姿势障碍
姿势性张力丧失	张力减退
娩出胎盘	娩出胎盘
婴儿烦躁不安	婴儿烦躁不安,烦躁不安
子宫一侧可触及境界不清包块	子宫不清,子宫包块,子宫触及
子宫一侧可触及条索状肿块	子宫条索状,子宫触及,子宫肿块
子宫一侧或两侧压痛	子宫压痛
子宫一侧触及肿物	子宫触及,子宫肿物
子宫一侧触及触痛肿块	子宫触及,子宫触痛,子宫肿块
子宫下段裂口	子宫裂口
子宫下移	子宫下移
子宫不再增大	子宫增大,子宫不再
子宫不均匀性增大	子宫不均匀,子宫增大
子宫不对称	子宫不对称
子宫不规则出血	子宫出血,子宫不规则,子宫不规则出血
子宫与停经月份更小	子宫小,停经月份小
子宫两侧压痛	子宫压痛
子宫两侧触及不规则形状肿块	子宫不规则,子宫肿块,子宫触及
子宫位于侧方	子宫位于
子宫体增大质软	子宫增大
子宫侧面触及增粗的输卵管	输卵管增粗,子宫增粗,输卵管触及,子宫触及
子宫偏于一侧	子宫偏于
子宫停止增长	子宫增长,子宫停止
子宫内膜过度增生	子宫内膜增生
子宫压痛	子宫压痛
子宫发育不良	子宫发育不良
子宫变软	子宫变软
子宫右上方可触及囊性肿块	子宫肿块,子宫触及
子宫后倾后屈	子宫后倾,子宫后倾后屈
子宫后倾固定	子宫后倾,子宫后倾固定,子宫固定
子宫后方触及触痛肿块	子宫肿块,子宫触及,子宫触痛
子宫固定	子宫固定
子宫均匀增大	子宫增大
子宫增大	子宫增大
子宫复旧不佳	子宫复旧不全,子宫复旧不佳
子宫复旧不全	子宫复旧不全
子宫复旧不良	子宫复旧不全,子宫不良
子宫大于孕周	子宫大于孕周,子宫增大
子宫大小与停经周数不符	子宫不符,停经周数不符
子宫大小与停经周数略小	子宫大小与停经周数略小
子宫大小稍大	子宫增大,子宫稍大
子宫小	子宫小
子宫局限性结节隆起	子宫结节,子宫隆起
子宫左上方可触及囊性肿块	子宫肿块,子宫触及
子宫底升高	子宫底升高
子宫异常变软	子宫变软,子宫异常
子宫异常增大	子宫增大,子宫异常
子宫张力大	子宫张力大
子宫收缩	子宫收缩
子宫收缩停止	子宫停止,子宫收缩
子宫收缩有间歇	子宫收缩
子宫敏感	子宫敏感
子宫旁光滑囊性肿块	宫旁肿块,宫旁光滑
子宫旁包块见妊娠囊	宫旁包块
子宫横椭圆形	子宫横椭圆形
子宫比妊娠月份小	子宫小
子宫活动受限	子宫活动受限
子宫漂浮感	子宫漂浮感
子宫略增大较软	子宫增大
子宫直肠陷凹波动感	子宫波动感,直肠波动感,子宫直肠陷凹
子宫直肠陷凹触痛	子宫触痛,子宫直肠陷凹,直肠痛
子宫短期内明显增大	子宫明显,子宫增大
子宫破裂征象	子宫破裂
子宫硬如板状	子宫板状
子宫稍大	子宫稍大
子宫紧裹胎儿感	子宫紧裹胎儿感
子宫缩小	子宫缩小
子宫萎缩	子宫萎缩
子宫表面结节突起	表面突起,表面结节,子宫突起,子宫结节
子宫触及肿块	子宫触及,子宫肿块
子宫质地不软	子宫不软,质地不软,子宫质地不软
子宫质地变软	子宫质地变软,质地变软,子宫变软
子宫轮廓不清	子宫轮廓不清
子宫软	子宫软
子宫较停经周数小	停经周数小,子宫小
子宫输卵管碘油造影见子宫正常，输卵管通而不畅或不通，有结核时输卵管呈现出串珠状	输卵管不畅,输卵管结核
子宫颈举痛	子宫颈举痛,宫颈举痛
子宫颈充血水肿	宫颈充血,子宫颈水肿,子宫颈充血
子宫颈光滑	子宫颈光滑
子宫颈呈糜烂样改变	宫颈糜烂,子宫颈改变,子宫颈糜烂
子宫颈局部红斑	子宫颈红斑
子宫颈息肉	子宫颈息肉
子宫颈息肉状赘生物	子宫颈息肉
子宫颈旁组织增厚	子宫颈增厚,组织增厚
子宫颈白色上皮	子宫颈白色上皮
子宫颈管有黏液脓性分泌物流出	分泌物流出,子宫颈管流出
子宫颈管膨大	宫颈管膨大,子宫颈管膨大
子宫颈糜烂样改变	子宫颈糜烂,子宫颈改变,宫颈糜烂
子宫颈糜烂样表现	子宫颈糜烂,子宫颈表现,宫颈糜烂
子宫颈肥大	子宫颈肥大
子宫颈菜花状赘生物	子宫颈赘生物,宫颈赘生物
子宫颈赘生物	子宫颈赘生物,宫颈赘生物
子宫颈黏膜外翻	黏膜外翻,子宫颈黏膜外翻,子宫颈外翻
子痫前期征象	子痫前期
孕28周前的先兆子痫	孕,子痫
孕28周后连续三次孕检孕妇体重不增长	孕
孕妇心率加快	心率快,心率增快,脉率加快,心率加快
孕早期短暂贫血	贫血
孕早期阴道流血史	阴道出血,阴道流血
孕晚期孕妇每周增加体重<0.5kg	体重增加
孕酮增高	孕酮增高
存在感觉障碍平面	感觉障碍,感觉存在
季肋部疼痛	季肋部疼痛
季肋部胀痛感	季肋部胀痛感
孤僻	孤僻
孤立性黄色丘疹	丘疹,皮疹
学习困难	学习困难
学习新鲜事物出现困难	学习困难,学习出现
学习能力下降	学习能力下降,学习不能
学龄儿童成绩下降	成绩下降
安静时不自主运动减轻	不自主运动
安静时发生肢体软瘫	软瘫,肢体安静
安静时脐部肿块消失	脐部消失,脐部安静,脐部肿块
完全性失语	失语
完全性皮质盲	皮质盲
定位障碍	定位障碍
定向力障碍	定向力障碍
定向能力下降	定向能力下降
定向障碍	定向障碍
室上性心动过速	室上性心动过速
室上性心动过速伴房室传导阻滞	室上性心动过速,房室传导阻滞
室带变形	室带变形
室带红色隆起	室带隆起,室带红色
室带肥厚	室带肥厚
室带阻塞声门	室带阻塞声门
室带黄色隆起	室带黄色,室带隆起
室性心动过速	室性心动过速
室性心律失常	心律失常
室性早搏	室性早搏
室性期前收缩	心律失常,室性期前收缩,心律不齐
室速	室性心动过速,室速
室间隔缺损	室间隔缺损
宫体压痛	宫体压痛
宫体稍大	子宫增大,宫体稍大
宫口不扩张	宫口不扩张
宫口扩张停滞	宫口扩张停滞,宫口扩张
宫口扩张缓慢	宫口扩张缓慢,宫口扩张
宫口松弛	宫口松弛
宫外孕	宫外孕
宫底位置较高	宫底位置较高
宫底部触到胎头最清晰	胎头最清晰
宫旁炎性包块	宫旁包块
宫旁组织触痛	宫旁组织触痛
宫旁结缔组织压痛	宫旁压痛,结缔组织压痛,宫旁结缔组织压痛
宫旁结缔组织增厚	宫旁结缔组织增厚,结缔组织增厚,宫旁增厚
宫旁结节状物	宫旁结节状物
宫旁肿块压痛	宫旁压痛,宫旁肿块
宫缩不协调	宫缩不协调,子宫收缩异常
宫缩乏力	子宫收缩异常,宫缩乏力
宫腔积脓	宫腔积脓
宫腔触及残留组织	宫腔触及,组织触及
宫腔触及残留血块	宫腔触及
宫颈不易触及胎先露部	胎先露部不易触及,宫颈不易触及,宫颈不易触及胎先露部
宫颈举痛	宫颈举痛
宫颈位置上移	宫颈位置上移
宫颈充血	宫颈充血
宫颈充血水肿	宫颈水肿,宫颈充血
宫颈内口紧闭	宫颈内口紧闭,宫颈口关闭
宫颈分泌物、输卵管管腔液、后穹隆穿刺液有时能检出淋菌、沙眼衣原体、支原体	沙眼
宫颈前唇水肿	前唇水肿,宫颈水肿
宫颈口已扩张	宫口扩张,宫颈口已扩张
宫颈口扩张	宫颈扩张,宫颈口扩张
宫颈口新生物	宫颈口新生物
宫颈口有妊娠物堵塞	宫颈口堵塞
宫颈口未开	宫颈口未开
宫颈口松弛	宫颈口松弛
宫颈口缩小	宫颈口缩小
宫颈口触及赘生物	宫颈口赘生物,宫颈口触及
宫颈处有黄色分泌物	分泌物黄色,宫颈处黄色
宫颈外口或颈管内肿物	宫颈外口肿物,颈肿块
宫颈外口扩张边缘很薄	宫颈扩张
宫颈展平≥80%	宫颈展平
宫颈扩张	宫颈扩张
宫颈扩张1cm以上	宫颈扩张
宫颈排出血性奇臭脓液	脓液
宫颈接触性出血	宫颈出血
宫颈摇摆痛	宫颈摇摆痛
宫颈新生物	宫颈新生物
宫颈显著膨大	宫颈膨大
宫颈有出血斑点	宫颈出血斑点
宫颈水肿	宫颈水肿
宫颈溃疡	宫颈溃疡
宫颈空洞	宫颈空洞
宫颈管内新生物	宫颈管新生物
宫颈管内癌组织脱出	癌组织脱出,宫颈管脱出
宫颈管消退	宫颈管消退
宫颈管缩短	宫颈管缩短
宫颈粘膜红斑	宫颈红斑,粘膜红斑
宫颈糜烂	宫颈糜烂
宫颈肥大	宫颈肥大
宫颈肥大质硬	宫颈质硬,宫颈肥大
宫颈肿物接触性出血	宫颈出血,宫颈肿物
宫颈裂口	宫颈裂口
宫颈触之易出血	宫颈触之易出血
宫颈触痛	宫颈触痛
宫颈赘生物质脆易出血	宫颈质脆,宫颈赘生物
宫颈进行性改变	宫颈改变
宫颈黑加征	宫颈黑加征
宫高小于孕周	宫高小于孕周
容易激动	容易激动
宽额头	宽额头
寒性脓肿	脓肿
寒战	寒战
对侧上象限盲	象限盲
对侧下象限盲	象限盲
对侧不自主运动	不自主运动
对侧中枢性面舌瘫	面舌瘫
对侧偏瘫	偏瘫
对侧偏盲	偏盲
对侧偏身感觉障碍	偏身感觉障碍
对侧健眼的间接光反射消失	光反射消失,对光反射消失
对侧共济失调	共济失调
对侧同向偏盲	偏盲
对侧同向性偏盲	偏盲
对侧完全性偏瘫	偏瘫
对侧感觉障碍	感觉障碍
对侧深感觉障碍	深感觉障碍
对侧肢体瘫痪	瘫,瘫痪
对侧舌瘫	舌瘫
对侧轻偏瘫	轻偏瘫
对侧面瘫	面瘫
对光反射消失	对光反射消失
对光反射迟钝	对光反射迟钝
对光反应消失	对光反应消失
对周围反应迟钝	反应迟钝
对声、光、风、痛敏感	光痛,光敏感
对声光敏感	光敏感
对外界反应低下	反应迟钝,反应差,反应低下
对家庭和社会失去责任感	责任感失去
对日常活动缺乏兴趣	活动缺乏
对称性关节肿痛	关节肿,关节痛,关节肿痛
对称性多关节痛	关节痛
对称性湿罗音	湿啰音,湿罗音,肺部啰音
对称性痛觉缺失	痛觉缺失
对称性肌无力	肌无力,四肢无力
对称性肢体无力	乏力,肢体无力,四肢无力
对称性近端肢体肌力下降	肢体下降,肢体肌力下降,肌力下降,肌力减弱
对称性近端肢体肌无力	四肢无力,肌无力
对称性远端肢体感觉障碍	感觉障碍,肢体感觉障碍,肢体障碍
对自己偏瘫不关心	偏瘫
对话能力下降	对话能力下降
对身边的人充满敌意	敌意
射精痛	射精痛
射血分数降低	射血分数降低
小三阳	小三阳
小便失禁	小便失禁
小儿下肢假性瘫痪	瘫痪,瘫
小儿下肢压痛	下肢压痛
小儿下肢肿胀	下肢肿胀,肢体肿胀
小儿髋关节外展	髋关节外展
小头	小头
小头畸形	小头,小头畸形
小字征	小字征
小指对掌无力	小指对掌无力
小指感觉减退	小指感觉减退,感觉减退,小指减退,感觉障碍
小指感觉消失	小指感觉消失,感觉障碍,感觉消失,小指消失
小指收展受限	小指受限
小指爪状畸形	小指畸形
小指皮肤感觉异常	小指感觉异常,皮肤感觉异常,小指皮肤感觉异常
小细胞低色素性贫血	贫血
小肌肉萎缩	肌肉萎缩,肌肉小,肌萎缩
小肠绒毛中央乳糜管扩张	乳糜管扩张
小肠结肠炎表现	小肠表现,结肠炎
小脑共济失调	小脑共济失调
小脑性共济失调	共济失调
小脑扁桃体疝	小脑扁桃体疝
小脑萎缩	小脑萎缩
小腹胀痛	腹痛
小腿以下皮肤感觉异常	小腿感觉异常,皮肤感觉异常
小腿前外侧感觉障碍	小腿障碍,感觉障碍
小腿后外侧疼痛	腿痛,小腿痛,小腿疼痛
小腿后面感觉障碍	小腿障碍,感觉障碍
小腿外侧感觉障碍	感觉障碍,小腿障碍
小腿外侧麻木	小腿麻木
小腿屈侧触痛性红色结节	小腿结节
小腿疼痛	腿痛,小腿痛,小腿疼痛
小腿肌肉痉挛	肌肉痉挛,痉挛
小腿肌肉萎缩	肌萎缩,肌肉萎缩,小腿萎缩,小腿肌肉萎缩
小腿肌萎缩	小腿肌萎缩,肌萎缩
小腿胀痛	腿痛,小腿胀痛
小腿触觉减退	小腿触觉减退,触觉障碍,触觉减退,小腿减退
小腿震动觉缺失	小腿缺失,震动觉缺失,小腿震动觉缺失
小颌畸形	小颌,小颌畸形
小鱼际皮肤感觉异常	皮肤感觉异常
小鱼际肌感觉减退	肌减退,感觉障碍,感觉减退
小鱼际肌感觉消失	肌消失,感觉障碍,感觉消失
小鱼际肌肉萎缩	肌肉萎缩,肌萎缩
小鱼际肌萎缩	肌萎缩
少尿	少尿
少汗	少汗
少泪	少泪
少痰	少痰
少语	少语
少量胸腔积液	胸腔积液
少量血性腹水	腹水
尖叫	尖叫
尖声哭叫	尖叫,尖声哭叫
尖头畸形	尖头畸形
尖腹	尖腹,腹包块,腹部膨隆
尺侧一指半掌侧痛觉减退	痛觉减退
尺动脉搏动存在	尺动脉搏动存在
尺神经沟处Froment征阳性	尺神经沟处阳性
尺神经沟处Tinel 征阳性	尺神经沟处阳性
尺骨茎突骨折	尺骨茎突骨折
尺骨鹰嘴后突	尺骨鹰嘴后突
尿HCG阳性	尿HCG阳性
尿不尽感	尿不尽感,尿不尽
尿中排出坏死组织	尿中排出
尿中排石	尿中排石
尿中有泡沫	尿中有泡沫
尿中有腐肉	尿中有腐肉
尿中有血块	尿中有血块
尿亚硝酸盐阳性	尿亚硝酸盐阳性
尿便失禁	尿便失禁
尿便潴留	潴留,尿便潴留
尿便障碍	尿便障碍
尿含铁血黄素阳性	尿阳性,尿含铁血黄素
尿外渗	尿外渗
尿外渗及血肿	尿外渗,血肿
尿失禁	尿失禁,大小便失禁
尿少	少尿,尿少
尿崩	尿崩
尿崩症	尿崩症,尿崩
尿布有臭味	尿布臭味
尿微量白蛋白增高	微白蛋白尿
尿急	尿急
尿意减弱	尿意减弱
尿本周蛋白阳性	尿阳性
尿毒症	尿毒症
尿毒症症状	尿毒症
尿比重<1.010	尿比重降低,尿比重<1.010
尿比重低	尿比重降低,尿比重低
尿比重增高	尿比重增高
尿比重降低	尿比重降低
尿流缓慢	尿流缓慢
尿液中断	尿液中断
尿液异味	尿液异味
尿液浑浊	尿液浑浊
尿液混浊	尿液混浊,尿液浑浊
尿液颜色变深	尿液变深,尿液颜色变深,颜色变深
尿淀粉酶增高	尿淀粉酶增高,尿淀粉酶升高
尿渗透压低	尿渗透压低
尿渗透压增高	尿渗透压增高
尿潴留	尿潴留
尿痛	尿痛
尿瘘	尿瘘
尿白细胞增多	尿白细胞阳性,尿白细胞升高,尿白细胞增多
尿白细胞管型	尿白细胞管型
尿白细胞阳性	尿白细胞阳性
尿粘多糖阳性	尿阳性
尿糖阳性	尿糖阳性,尿葡萄糖阳性
尿素氮升高	尿素氮升高
尿红细胞增多	尿红细胞增多,红细胞增多
尿红细胞阳性	尿阳性,红细胞阳性,尿红细胞阳性
尿细菌培养阳性	尿细菌培养阳性
尿肺炎链球菌抗原阳性	尿阳性,肺炎链球菌
尿胆原阳性	尿胆原阳性
尿胆红素阳性	尿胆红素阳性
尿色加深	尿色加深,血尿,尿色深
尿色变深	尿色变深,血尿,尿色深
尿色如浓红茶	尿色如浓红茶
尿色深	血尿,尿色深
尿色深黄	尿色深黄,尿黄色
尿色黄	尿黄色,尿色黄
尿葡萄糖阳性	尿糖阳性,尿葡萄糖阳性
尿蛋白≥0.3g/24h	尿蛋白
尿蛋白增多	蛋白尿阳性,尿蛋白,尿蛋白增多
尿蛋白阳性	尿蛋白,蛋白尿阳性,尿蛋白阳性
尿蛋白＞3.5g/d	尿蛋白
尿路刺激征	尿路刺激征
尿路感染	尿路感染
尿道出血	尿道出血
尿道分泌物查到淋病双球菌	淋病
尿道刺痒	尿道刺痒
尿道刺痛	尿道刺痛
尿道压痛	尿道压痛
尿道口出血	尿道口出血
尿道口刺痛	尿道口刺痛
尿道口发痒	尿道口发痒
尿道口小肿块	尿道口小,尿道口肿块
尿道口流脓	尿道口流脓
尿道口滴白	尿道口滴白
尿道口滴脓	脓
尿道口烧灼样疼痛	尿道口疼痛
尿道口疼痛	尿道口疼痛
尿道口痒	尿道口痒
尿道口瘙痒	尿道口瘙痒
尿道口糜烂	尿道口糜烂
尿道口红肿	尿道口红肿
尿道口红肿触痛	尿道口红肿,尿道口触痛
尿道口肿块	尿道口肿块
尿道口脱出环形肿块	尿道口肿块,尿道口脱出
尿道口黏膜充血水肿	尿道口水肿,黏膜水肿,黏膜充血,尿道口充血
尿道口黏膜红肿	尿道口黏膜红肿,尿道口红肿,黏膜红肿
尿道开口异常	尿道开口异常
尿道排出白色稀薄液体	尿道稀薄,尿道白色,尿道排出
尿道排出脓性分泌物	分泌物排出,尿道排出
尿道流血	尿道流血
尿道灼热	尿道灼热
尿道痂膜封口	尿道痂膜封口,尿道封口,痂膜封口
尿酮体阳性	尿酮体阳性,尿酮体
尿酮阳性	尿酮阳性
尿酸碱度增高	尿酸碱度增高
尿酸碱度降低	尿酸碱度降低
尿量减少	尿量减少,尿少
尿量增多	尿量增多
尿钙增高	尿钙增高
尿钠减少	尿钠减少
尿钠增加	尿钠增高,尿钠增加
尿镜检钩端螺旋体阳性	尿阳性
尿闭	尿闭
尿隐血阳性	血尿,尿隐血阳性
尿雌三醇与肌酐（E／C）比例<10	中性粒细胞升高
尿雌激素降低	雌激素减少,尿雌激素降低
尿频	尿频
局灶性癫痫	癫痫
局部淋巴结一般不肿大	淋巴结不肿大
局部淋巴结肿大	淋巴结肿大
局部症状	局部症状
局部皮温升高	皮温升高
局部皮温增高	皮温升高
局部皮肤压痛	皮肤压痛
局部皮肤弥漫性红肿	皮肤肿胀,皮肤红肿
局部皮肤温热	皮肤温热
局部皮肤灼热感	皮肤灼热感
局部皮肤烧灼样疼痛	皮肤痛,皮肤疼痛
局部皮肤粗厚	皮肤粗厚
局部皮肤红肿	皮肤肿胀,皮肤红肿
局部皮肤肿痛	皮肤肿痛,皮肤肿胀,皮肤痛
局部皮肤脱屑	皮肤脱屑,脱屑
局部肋软骨有压痛	肋软骨压痛
局部肋软骨肿大隆起	肋软骨隆起,肋软骨肿大
局部肌肉热痛性肿胀	肌肉肿胀,肌痛
局部肌肉肿胀疼痛	肌肉疼痛,肌肉肿胀,肌痛,肌肉痛
局部脂肪组织增生	脂肪组织肥大
局部脂肪组织肥大	脂肪组织肥大
局部血肿	血肿
局部软组织擦伤瘀血	软组织擦伤
局限性干啰音	喘鸣音,干啰音,哮鸣音
局限性癫痫	癫痫
局限性肌肉疼痛	肌痛,肌肉疼痛,肌肉痛
局限性腹胀	腹部不适,腹胀
局限性运动障碍	运动异常,运动障碍
屈曲姿势	姿势屈曲
屈肌痉挛	屈肌痉挛,痉挛
屈肌腱见孤立结节	肌腱孤立结节
屈肘无力	无力,屈肘无力
屈腕时环小指疼痛	屈腕疼痛
屈腕时麻木加重	屈腕加重,屈腕麻木
屈膝受限	屈膝受限
展神经麻痹	展神经麻痹
工作学习能力减退	工作学习能力减退
工作效率低	工作效率低
左上腹不适	腹不适
左上腹包块	腹包块
左上腹坠胀感	腹坠胀感
左上腹疼痛	腹疼,腹痛
左下腹压痛	腹部压痛
左下腹痛	腹痛
左下腹肌紧张及反跳痛	腹肌紧张,反跳痛,腹部压痛,痛
左下腹肿块	腹包块,腹肿块
左侧深感觉障碍	深感觉障碍
左侧肢体共济失调	肢体共济失调,共济失调
左侧面瘫	面瘫
左季肋部摩擦感	季肋部摩擦感
左季肋部疼痛	季肋部疼痛
左室增大	左室增大
左室收缩功能下降	左室收缩功能下降
左室收缩功能减退	左室收缩功能减退
左室舒张功能减退	左室舒张功能减退
左心室室壁运动减弱	左心室室壁运动减弱,心脏搏动减弱,室壁运动异常
左心室扩大	左心室扩大
左心室搏动消失而右心室搏动正常	右心室搏动
左心室肥厚	左心室肥厚,心室肥厚
左心室肥大	左心室肥大,左心室扩大
左心室舒张功能异常	左心室舒张功能异常
左肩部疼痛	肩部疼痛,肩痛
左背部疼痛	背痛,背部疼痛
左腹部明显膨胀	腹部明显,腹部膨胀,腹胀
左锁骨上淋巴结肿大	锁骨上淋巴结肿大,淋巴结肿大
左锁骨下淋巴结肿大	锁骨肿大,淋巴结肿大
巧克力色胸水	胸水
巨人症	巨人症
巨噬细胞心肌炎	心肌炎
巨脾	巨脾
巩膜外层炎	巩膜炎
巩膜炎	巩膜炎
巩膜黄染	黄疸,巩膜黄染
差异性发绀	发绀
巴彬斯基征阳性	巴彬斯基征阳性,巴彬斯基征
帕氏线	帕氏线
帕金斯综合征	帕金斯综合征
帕金斯综合征样表现	帕金斯综合征
帕金森样症状	帕金森样症状
帕金森综合征	帕金森样症状,帕金森综合征
干呕	干呕
干咳	咳嗽,干咳
干咳加重	干咳加重,咳嗽,干咳
干啰音	干啰音,哮鸣音,喘鸣音
干湿啰音	肺部啰音,湿啰音
干眼症	干眼症,干眼
平卧时气急	气促,气急
平喘药物治疗后呼吸困难缓解	气促,呼吸困难
平地步行困难	步行困难
平衡失调	平衡失调
平衡障碍	平衡障碍
并指	并指
并殖吸虫抗原皮内试验阳性	皮内试验阳性
并用手支撑躯干成俯跪位	手俯跪位,手支撑,躯干俯跪位,躯干支撑
并趾	并趾
幻听	幻听
幻嗅	幻嗅
幻视	幻视
幻觉	幻觉
广泛肌萎缩	肌萎缩
库欣综合征	库欣综合征
延髓背外侧综合征	延髓背外侧综合征
延髓部肌肉无力	无力,肌肉无力,四肢无力
延髓麻痹	延髓麻痹
开始咀嚼时不能张口	咀嚼不能,张口不能
开锁困难	开锁困难
异位肾	异位肾
异常体重减轻	体重减轻
异常出汗	出汗
异常恶露	恶露
异常步态	步态障碍
异常阴道流血	阴道出血,阴道流血
异食癖	异食癖
弓形虫循环抗原阳性	弓形虫,弓形体病
弓形虫抗体阳性	弓形体病,弓形虫
弓形足	足弓形
弛张热	弛张热
弛缓性瘫痪	瘫,瘫痪
张口受限	张口受限
张口呼吸	张口呼吸
张口困难	张口困难
张口度变小	张口度变小
张口时下颌偏斜	张口偏斜,下颌偏斜
张口时下颌关节疼痛	关节痛,关节疼痛
张口过大	张口过大
张口过小	张口过小
弥散功能升高	弥散功能升高
弥散功能降低	弥散功能降低
弥散功能障碍	弥散功能障碍
弥散性血管内凝血	弥散性血管内凝血
弥漫性甲状腺肿	甲状腺肿大
弥漫性肺泡出血	出血
弥漫性腹膜炎	腹膜炎
弥漫性腹部绞痛	腹部绞痛,腹痛
弥漫性血管内凝血	弥漫性血管内凝血
弯腰转身困难	弯腰困难,弯腰转身困难,转身困难
弹响拇	弹响指,弹响拇
弹响指	弹响指
强哭强笑	强笑,强哭
强握	强握
强握反射	强握反射,强握
强烈活动双腿的愿望	活动强烈,双腿强烈
强直-痉挛反复发作	痉挛
强直-阵挛发作	强直-阵挛,强直-阵挛发作
强直性惊厥	惊厥
强直性脊柱炎家族史	强直性脊柱炎
强直痉挛	痉挛
强迫头位	强迫头位
强迫症状	强迫症
强迫症状不是其他精神障碍引起	强迫症,精神障碍
强迫观念	强迫观念
影像学异常	影像学异常
影像学检查：肝表面粗糙不均、肝回声显示增强、肝大	肝大
循环衰竭表现	循环衰竭
微丝蚴检查阳性	微丝蚴检查阳性
微血管病性溶血性贫血	微血管病性溶血性贫血
微血管脆性增加	脆性增加,微血管脆性增加,微血管增加
心内结构畸形	心内结构畸形
心内膜炎	心内膜炎
心前区不适	心前区不适,心绞痛
心前区刺痛	胸痛,心前区痛,心前区刺痛
心前区压迫感	心前区压迫感
心前区扪及收缩期抬举性搏动	心前区扪及
心前区搏动弥散	心前区搏动弥散
心前区收缩期杂音	心前区收缩期杂音,心脏杂音,收缩期杂音,心尖区收缩期杂音
心前区疼痛	心前区疼痛,胸痛,心前区痛
心前区痛	胸痛,心前区痛,心前区疼痛
心前区突出	心前区突出
心前区闷痛	心前区痛,胸痛,心前区闷痛
心前区隆起	心前区隆起
心前区饱满	心前区饱满
心力衰竭	心衰,心力衰竭
心动过缓	心动过缓
心动过缓-过速综合征	心动过缓
心动过速	心动过速,心率快
心动过速突发突止	心率快,心动过速
心包填塞	心包填塞
心包摩擦感	心包摩擦感
心包摩擦音	心包摩擦音
心包炎	心包炎
心包积液	心包积液
心包腔内液性暗区	心包腔液性暗区
心包钙化	心包钙化
心室壁变薄	心室壁变薄
心室壁运动异常	室壁运动异常,心室壁运动异常
心室扑动	心室扑动
心室肥厚	心室肥厚
心室腔变小	心室腔变小
心室颤动	心室颤动
心尖区吹风样收缩期杂音	心脏杂音,心尖区收缩期杂音
心尖区扪及舒张期震颤	心尖区扪及,心尖区震颤
心尖区收缩期杂音	心脏杂音,心尖区收缩期杂音
心尖区第一心音减弱	第一心音减弱,心尖区减弱,心尖区第一心音减弱
心尖区第一心音强度恒定	心尖区强度恒定,心尖区第一心音强度恒定,第一心音强度恒定
心尖区舒张中晚期隆隆样杂音	心尖区隆隆样杂音
心尖搏动减弱	心尖搏动减弱
心尖搏动向左下移位	心尖搏动,心尖搏动移位
心尖搏动增强	心尖搏动增强,心尖搏动
心尖搏动弥散	心尖搏动弥散
心尖搏动消失	心尖搏动减弱,心尖搏动,心尖搏动消失
心尖部收缩期吹风样杂音	心尖区收缩期杂音,心前区收缩期吹风样杂音,心尖部收缩期吹风样杂音
心尖部第一心音减弱	第一心音减弱,心尖部第一心音减弱,心尖部减弱
心尖部舒张期杂音	心尖部舒张期杂音
心尖部闻及收缩期吹风样杂音	心前区收缩期吹风样杂音,心尖部收缩期吹风样杂音,心尖区收缩期杂音
心尖部闻及收缩期杂音	收缩期杂音,心尖区收缩期杂音,心尖部收缩期杂音,心尖部杂音,心脏杂音
心底部收缩期震颤	心底部收缩期震颤,收缩期震颤
心影增大	心影增大
心影增大，呈梨形	心影增大
心律不恒定	心律不恒定
心律不规则	心律不规则
心律不齐	心律不恒定,心律不齐
心律失常	心律失常
心律绝对不齐	心律绝对不齐,心律不恒定
心悸	心悸
心慌	心慌,心悸
心房纤颤	心房纤颤,心房颤动
心房颤动	心房颤动
心搏动减弱	心搏动减弱
心搏提前出现	心搏提前,心搏出现
心搏脱漏	心搏脱漏
心浊音界扩大	心脏增大,心浊音界扩大
心源性休克	休克
心烦气躁	心烦气躁
心率160-180次/分	心率加快,心率快,脉率加快,心率增快
心率不规则	心律不齐,心率不规则,心律不恒定
心率减慢	心率减慢,心律变慢,心率慢
心率加快	心率加快,心率增快,心率快,脉率加快
心率增快	心率快,心率加快,脉率加快,心率增快
心率失常	心率失常
心率快	心律失常,心率快
心率快持续时间小于30秒	心率快,心律失常,心率慢,心率减慢,心律变慢
心率慢	心率慢
心率明显增快	心率明显,心率增快,心率加快,心率快,脉率加快
心率＞120次/分	心率增快,心率快,心率加快,脉率加快
心率＞160次/分	脉率加快,心率增快,心率快,心率加快
心理情感异常	情感异常
心电图ST-T改变	ST-T改变
心电图左室高电压	左室高电压,心电图左室高电压
心电图示T波平坦或倒置	T波倒置
心电图见房室传导阻滞	房室传导阻滞
心界向左下扩大	心界向左下扩大,心界扩大
心界常向左下扩大	心界扩大,心界向左下扩大
心界扩大	心界扩大
心窝部异常搏动感	心窝部搏动感,心窝部异常
心绞痛	心绞痛
心绞痛持续时间延长	心绞痛
心绞痛频繁发作	心绞痛
心肌损害	心肌病变,心肌损害
心肌炎症状	心肌炎
心肌病变	心肌病变,心肌病
心肌纤维化	心肌纤维化
心肌缺血	心肌缺血
心肌肥厚	心肌肥厚
心肌酶谱升高	心肌酶谱升高
心脏传导阻滞	心脏传导阻滞
心脏停搏	心脏停搏
心脏停跳感	心脏停跳感
心脏扩大	心脏增大,心脏扩大
心脏搏动减弱	心脏搏动减弱
心脏摆动	心脏摆动
心脏杂音	心脏杂音
心脏浊音界缩小	浊音界缩小,心脏浊音界缩小,心脏缩小
心脏炎	心脏炎
心脏猝死家族史	猝死,心脏家族史
心脏瓣膜运动异常	运动异常,心脏瓣膜运动异常
心脏移位	心脏移位
心脏舒张功能下降	心脏舒张功能下降
心脏轻度增大	心脏增大
心脏附壁血栓	血栓
心脏骤停	心脏停搏,心脏骤停
心衰	心衰
心跳加速	心跳加速
心音低而遥远	心音遥远,心音减弱
心音低钝	心音低钝,心音减弱
心音减低	心音减弱,心音减低
心音减弱	心音减弱
心音遥远	心音遥远,心音减弱
快速 ACTH兴奋试验异常	兴奋
快速眼球运动受损	运动快速,眼球受损,运动受损,眼球快速
怕冷	怕冷
怕热	怕热
怕风	怕风
思维不连贯	思维障碍,思维不连贯
思维不集中	思维不集中
思维紊乱	思维紊乱,思维障碍
思维能力下降	思维能力下降
思维能力减退	思维能力减退
思维迟钝	思维迟钝,思维障碍
急性下腹痛	下腹痛,腹痛
急性出血坏死性胰腺炎	出血,胰腺炎
急性剧烈背痛	背痛
急性呼吸窘迫综合征	急性呼吸窘迫综合征
急性尿潴留	尿潴留
急性局限性水肿	局限性水肿
急性左心衰表现	左心衰
急性意识模糊	意识不清,意识模糊
急性意识模糊状态	意识不清,意识模糊
急性机械性肠梗阻表现	机械性肠梗阻
急性炎症症状	急性炎症
急性病容	急性病容
急性肾衰竭	急性肾衰竭
急性腹痛	腹痛
急性腹膜炎	急性腹膜炎
急性风湿热表现	风湿热
急性高原反应	高原反应
急腹症	急腹症
急躁易激动	急躁,易激动
急迫性尿失禁	尿失禁,大小便失禁
急骤的颈背痛	颈背痛
性交不适	性交困难,性交不适
性交后出血	出血
性交后腹痛	腹痛
性交后腹痛加重	腹痛
性交后阴道出血	阴道出血
性交后阴道分泌物气味加重	气味加重,阴道分泌物加重
性交困难	性交困难
性交痛	性交痛,性交困难
性冷淡	性冷淡
性功能减退	性功能减退
性功能障碍	性功能障碍,性欲障碍
性发育延迟	性发育延迟,性发育落后
性发育落后	性发育落后
性发育迟缓	性发育落后,发育障碍,性发育迟缓
性征发育提前	性征提前,发育提前,性征发育提前
性情急躁	性情急躁
性早熟	性早熟
性格改变	性格改变
性格狂躁	性格狂躁,狂躁
性欲亢进	性欲亢进
性欲减退	性欲障碍,性欲减退
性欲改变	性欲改变
性欲降低	性欲降低,性欲障碍
性腺功能减退	性腺功能减退
怪异表情	表情怪异
总IgE增高	总IgE增高
总胆固醇增高	总胆固醇增高
总胆固醇降低	总胆固醇降低
恍惚	恍惚
恐惧	恐惧
恐惧不安	恐惧,不安
恐惧感	恐惧感
恐慌	恐慌
恐水	恐水
息肉阻塞外耳道	外耳道息肉,外耳道阻塞
恶寒	恶寒
恶心	恶心
恶心呕吐	恶心,呕吐
恶性心律失常	心律失常
恶性贫血	恶性贫血
恶性高血压	高血压
恶液质	恶液质
恶病质	恶病质
恶露增多	恶露,恶露增多
患侧上睑下垂	睑下垂
患侧动眼神经麻痹	动眼神经麻痹
患侧单眼一过性失明	失明
患侧单眼一过性黒曚	黒曚
患侧声带固定于旁中位	声带固定于旁中位
患侧声带居旁中位不能外展	声带不能外展,声带居旁中位
患侧眼球外斜	眼球外斜
患侧瞳孔变小	瞳孔变小
患侧瞳孔散大	瞳孔散大,瞳孔放大
患侧耳后疼痛	耳后疼痛
患侧胸廓饱满	胸廓饱满
患侧闭眼时白色巩膜露出	闭眼露出,巩膜白色,巩膜露出,闭眼白色
患侧闭眼时眼球向外上方转动	闭眼向外上方转动,眼球向外上方转动
患儿生长发育减慢	患儿生长发育减慢,生长发育减慢,患儿减慢
患儿自仰卧位起立时必须先翻身转为俯卧位	患儿仰卧位,患儿转为,患儿俯卧位
患处压痛	患处压痛
患处局部肿胀	患处肿胀
患处活动障碍	患处障碍,活动障碍,患处活动障碍
患处疼痛	患处疼痛
患处皮温升高	皮温升高,患处皮温升高,患处升高
患处皮肤局部肿痛	皮肤痛,皮肤肿胀,患处肿痛,皮肤肿痛
患指剧烈疼痛	患指疼痛
患指各指节呈轻度弯曲	指节弯曲,患指弯曲
患指弹响	患指弹响
患指肌腱功能丧失	患指肌腱功能丧失
患指肌腱坏死	肌腱坏死,患指坏死,患指肌腱坏死
患指肌腱缺血	患指肌腱缺血,肌腱缺血,患指缺血
患指肿胀皮肤极度紧张	患指紧张,皮肤肿胀,患指肿胀,皮肤紧张
患眼瞳孔直接光反射消失	瞳孔消失,瞳孔光反射消失,光反射消失,对光反射消失
患者喜欢温度较低的环境	温度较低
患肢不能活动	患肢不能活动
患肢乏力	乏力,患肢乏力
患肢异常活动	患肢异常活动,异常活动
患肢微屈	患肢微屈
患肢感觉异常	患肢感觉异常
患肢温度较低	患肢较低,温度较低,患肢温度较低
患肢疼痛	患肢疼痛
患肢肌力下降	患肢肌力下降,患肢下降,肌力减弱,肌力下降
患肢肿胀	患肢肿胀
患肢远侧动脉搏动减弱	动脉搏动减弱
患肢远侧动脉搏动消失	猝死,患肢消失,动脉搏动消失
患肢青紫色改变	患肢青紫,患肢改变
患肢麻木	患肢麻木
患髋关节前方压痛	关节痛,髋痛
患髋关节活动受限	髋关节活动受限
患髋关节轻度屈曲	髋关节屈曲
悬垂腹	腹悬垂
悬跛	悬跛
悬雍垂圆形突起	悬雍垂突起,悬雍垂圆形
悬雍垂水肿	悬雍垂水肿
悬雍垂颗粒状瘤	悬雍垂瘤,悬雍垂颗粒状
悲观绝望	悲观,绝望
情感改变	情感改变
情感淡漠	情感淡漠,情感障碍
情感障碍	情感障碍
情绪不稳	情绪不稳
情绪不稳定	情绪不稳,情绪不稳定
情绪低落	情绪低落
情绪变化	情绪变化
情绪波动大	情绪大,情绪波动
情绪淡漠	情感障碍,情绪淡漠,淡漠
情绪激动	情绪激动
情绪激动后胸痛	情绪激动,胸痛
情绪紧张时不自主运动加重	情绪加重,情绪紧张,不自主运动
惊厥	惊厥
惊叫	惊叫
惊恐	惊恐
惊恐不安	惊恐不安
意向性肌颤	肌颤
意志力丧失	意志力丧失,意志缺失
意志缺失	意志缺失
意识不清	意识不清
意识丧失	意识不清,意识丧失
意识丧失持续不超过半小时	意识不清,意识丧失
意识丧失持续数分钟至十余分钟	意识不清,意识丧失
意识恢复	意识恢复
意识改变	意识改变
意识模糊	意识不清,意识模糊
意识混乱	意识不清,意识混乱
意识紊乱	意识紊乱,意识不清
意识蒙胧	意识蒙胧
意识障碍	意识障碍,意识不清
意识障碍伴高热	高热,意识障碍,意识不清,发热
意识障碍进行性加重	意识不清
感冒症状	感冒
感染性坏疽	坏疽
感染性肌炎	肌炎
感觉丧失	感觉丧失,感觉障碍
感觉减退	感觉障碍,感觉减退
感觉性共济失调	共济失调
感觉性失语	失语
感觉无法工作	感觉无法工作,无法工作
感觉神经异常	感觉障碍,感觉神经异常
感觉过敏	感觉障碍,感觉过敏
感觉错乱	感觉障碍,感觉错乱
感觉障碍	感觉障碍
感音神经性耳聋	耳聋
慌张步态	慌张步态
慢性不完全性肠梗阻表现	不完全性肠梗阻
慢性反复上腹痛	腹痛,上腹痛
慢性咳嗽	咳嗽
慢性广泛性肌肉疼痛	肌肉痛,肌痛,肌肉疼痛
慢性支气管炎	慢性支气管炎
慢性游走性红斑	慢性游走性红斑
慢性疲劳综合征	慢性疲劳综合征
慢性盆腔痛	盆腔痛,盆腔疼痛
慢性腹泻	慢性腹泻
慢性萎缩性肢端皮炎	皮炎
慢性进行性肌无力	肌无力,四肢无力
憋气	胸闷,呼吸困难,憋气
憋醒	夜间憋醒,憋醒
成绩下降	成绩下降
截瘫	截瘫
房室传导阻滞	房室传导阻滞
房性心律失常	心律失常
房扑	房扑
房间隔缺损	房间隔缺损
房颤伴完全性房室传导阻滞	完全性房室传导阻滞,心房颤动,房颤
房颤伴房室结性心律	心房颤动,房颤
扁头畸形	扁头畸形
扁平足	扁平足
扁平骨病理性骨折	骨扁平,骨折
扁平骨肿块	骨肿块,骨扁平
扁桃体与周围组织粘连	扁桃体粘连,组织粘连
扁桃体充血	扁桃体充血
扁桃体凹凸不平	扁桃体凹凸不平
扁桃体周红肿	扁桃体肿大
扁桃体圆形囊肿	扁桃体囊肿,扁桃体圆形
扁桃体圆形突起	扁桃体突起,扁桃体圆形
扁桃体瘢痕凹凸不平与周围组织粘连	组织瘢痕,扁桃体凹凸不平,扁桃体粘连,组织凹凸不平,组织粘连,扁桃体瘢痕
扁桃体结节状隆起	扁桃体结节状,扁桃体隆起
扁桃体肥大	扁桃体肥大
扁桃体肿大	扁桃体肿大
扁桃体脓点	扁桃体脓点
扁桃体表面溃烂	表面溃烂,扁桃体表面溃烂,扁桃体溃烂
扁桃体表面灰色假膜	假膜
扁桃体表面白色渗出物或假膜	扁桃体渗出物,扁桃体白色,表面白色,表面渗出物,假膜
扁桃体隐窝口豆渣样渗出物	扁桃体渗出物,隐窝口渗出物
扁桃体颗粒状瘤	扁桃体瘤,扁桃体颗粒状
手、足、面部麻木	足麻木,面部麻木,手足麻木,手麻木
手不能持物	手不能持物
手偏向桡侧	手偏向桡侧
手处于旋前位	手处于旋前位
手套-袜套样感觉减退	感觉障碍,感觉手套-袜套样,感觉减退
手抖	手抖
手指伸直	手指伸直
手指伸直受限	手指受限,手指伸直
手指依次出现苍白、青紫和潮红	手指潮红,手指出现,手指青紫,手指苍白
手指僵硬	手指僵硬
手指动作不灵活	手指动作不灵活,手指不灵活,动作不灵活
手指发凉	发冷,发凉,手指发凉
手指变短	手指变短
手指呈梭形肿大	手指肿大
手指失认症	失认,手指失认症
手指局部肿胀疼痛	手指疼痛,手指肿胀,手指痛
手指感觉过敏	感觉过敏,感觉障碍,手指过敏,手指感觉过敏
手指感觉迟钝	感觉障碍,手指迟钝,手指感觉迟钝,感觉迟钝
手指收展不灵活	手指收展不灵活
手指无痛性僵硬	手指僵硬
手指活动受限	手指活动受限
手指活动笨拙	手指活动笨拙,活动笨拙,手指笨拙
手指溃破窦道	手指溃破,手指溃破窦道,窦道溃破
手指潮红	手指潮红
手指疼痛	手指痛,手指疼痛
手指痛	手指痛,手指疼痛
手指硬化	手指硬化
手指精细动作减退或不能	手指减退,手指不能,手指精细动作不能,手指精细动作减退
手指纽扣花样表现	手指表现
手指缩短变形	手指变形,手指缩短
手指肿胀	手指肿胀
手指苍白	手指苍白
手指苍白发僵后转紫红	手指苍白发僵后转紫红
手指青紫	手指青紫
手指麻木	手指麻木
手掌扁平	手掌扁平
手掌桡侧半感觉减退	手掌减退
手掌桡侧半感觉消失	手掌消失
手术伤口渗血不止	出血不止,手术不止,伤口不止
手术后出血	出血
手术瘢痕处疼痛	手术疼痛,瘢痕处疼痛,手术瘢痕处疼痛
手术瘢痕深部扪及包块	瘢痕深部包块,手术扪及,手术包块,瘢痕深部扪及
手精细动作不灵便	手精细动作不灵便
手肌强直发作	手发作,肌强直,肌肉强直
手肿胀	手肿胀
手背尺侧感觉减退	感觉障碍,感觉减退,手背减退
手背尺侧感觉消失	感觉消失,感觉障碍,手背消失
手背尺侧皮肤感觉异常	皮肤感觉异常,手背感觉异常
手背桡侧感觉减退	感觉减退,感觉障碍,手背减退
手背肿胀	手部肿大,手背肿胀
手背肿胀史	手背肿胀,手部肿大
手脚增厚	手脚增大,手脚增厚
手脚增大	手脚增大
手脚掌皮肤姜黄色	皮肤姜黄色,手脚姜黄色
手脚粗大	手脚粗大,肢端肥大
手脚肥厚	手脚肥厚,手脚粗大
手足刺痛	手足刺痛
手足发冷	手足发冷,发冷
手足徐动	手足徐动
手足徐动症	手足徐动症,手足徐动
手足徐缓不规则不自主性蠕动	手足不规则,手足蠕动
手足心发黄	手足心发黄
手足抽搐	手足抽搐
手足搐搦	手足抽搐,手足搐搦
手足搐溺	手足搐溺,手足抽搐
手足无意识运动	手足无意识,手足无意识运动,运动无意识
手足硬性水肿	手足肿胀,水肿
手足肌肉痉挛	痉挛,肌肉痉挛
手足肿胀	手足肿胀
手足肿胀感	手足肿胀感
手足麻木	手足麻木
手部多汗	手部多汗,多汗
手部小肌肉无力	手部小肌肉无力,无力
手部小肌肉萎缩	手部小肌肉萎缩
手部小肌肉麻痹	手部小肌肉麻痹
手部小鱼际肌萎缩	肌萎缩
手部持物易坠落	坠落
手部无力	无力,手部无力
手部疱疹	手部疱疹,疱疹
手部痉挛	痉挛,手部痉挛
手部皮肤角化粗糙	皮肤粗糙,手部角化,皮肤角化,手部粗糙
手部肿胀	手部肿大,手部肿胀
手部骨间肌萎缩	肌萎缩,骨间肌萎缩
打哈欠	打哈欠
打喷嚏	打喷嚏
打软腿	腿打软
打鼾	打鼾
执行功能下降	执行功能下降,执行功能障碍
执行能力下降	执行能力下降,执行功能障碍
扩冠治疗后心绞痛不缓解	心绞痛
找词困难	找词困难
抑郁	抑郁
投掷样运动	运动投掷样
投掷症	投掷症
抗GBM抗体阳性	抗GBM抗体阳性
抗中性粒细胞抗体（ANCA）阳性	抗中性粒细胞抗体（ANCA）阳性
抗利尿激素(ADH)增多	抗利尿激素增高
披肩征	披肩征
抬举性心尖搏动	心尖搏动,抬举性心尖搏动
抬举样心尖搏动	心尖搏动
抬头困难	抬头困难
抬臂困难	抬臂困难
抬足困难	抬足困难
抽搐	抽搐
抽搐发作	抽搐,抽搐发作
拇指不能外展	拇指不能外展
拇指不能对掌	拇指不能对掌
拇指不能屈曲	拇指不能屈曲
拇指伸直外展不能	拇指伸直外展不能
拇指内收	拇指内收
拇指对掌无力	拇指对掌无力
拇指示指中指掌面感觉减退	示指减退,中指感觉减退,感觉减退,感觉障碍,拇指减退,掌面感觉消失,中指减退,掌面减退
拇指示指中指掌面感觉消失	拇指消失,掌面消失,感觉消失,中指消失,感觉障碍,掌面感觉消失,示指消失,中指感觉减退
拇指维持外展位	拇指维持外展位
拇指背侧近端感觉减退	近端感觉减退,拇指减退
拇收肌萎缩	拇收肌萎缩
拇趾内侧肿胀疼痛	拇趾疼痛,拇趾肿胀
拇趾向足外侧倾斜	拇趾向足外侧倾斜
拇趾外翻畸形	拇趾畸形,拇趾外翻
拒乳	拒乳,拒食,食欲减退
拒奶	拒奶,喂养困难
拒食	拒食
拔牙后出血难止	出血
拥抱反射减弱	拥抱反射减弱
括约肌不受累	括约肌不受累
括约肌功能丧失	括约肌功能丧失
括约肌功能障碍	括约肌功能障碍
持续1月以上的发热	发热
持续1月以上的盗汗	盗汗
持续1月以上的腹泻	腹泻
持续中上腹痛	上腹痛,腹痛
持续关节肿痛	关节肿,关节肿痛,关节痛
持续发热	发热
持续性上腹痛	上腹痛,腹痛
持续性乳房胀痛	乳房胀痛,乳房痛
持续性低钾血症	低钾血症,低钾血
持续性全身淋巴结肿大	淋巴结肿大,全身肿大
持续性剧烈腹痛	腹痛
持续性头痛	头痛
持续性流涕	流涕
持续性胸痛	胸痛
持续性腹痛	腹痛
持续性高尿酸血症	高尿酸血症
持续性高血压	高血压
持续抽搐	抽搐
持续昏迷	昏厥,昏迷,意识不清
持续活动后下肢无力	下肢无力
持续活动后下肢疼痛	下肢疼痛
持续腮腺肿大	腮腺肿大
持续腰背部痛	腰背部疼痛,腰背痛
持续腹痛	腹痛
持续腹部胀痛	腹部胀痛,腹痛
指垫变薄	指垫变薄
指垫消失	指垫消失
指尖坏疽	坏疽,指尖坏疽
指尖溃疡	指尖溃疡
指尖肌肉萎缩	肌萎缩,指尖萎缩,肌肉萎缩,指尖肌肉萎缩
指掌部红斑	指掌部红斑
指甲/趾甲变厚淡褐色	指甲淡褐色,趾甲淡褐色,指甲变厚,趾甲变厚
指甲/趾甲无光泽	指甲无光泽,趾甲无光泽
指甲出现纵嵴	指甲出现,指甲纵嵴
指甲发育不良	发育障碍,指甲发育不良,发育不良
指甲变厚	指甲变厚
指甲变平	指甲变平
指甲床青紫	指甲床青紫,甲床青紫,青紫
指甲松脆	指甲松脆
指甲粗糙	指甲粗糙
指甲缺乏光泽	指甲缺乏光泽
指甲苍白	指甲苍白
指甲顶针样凹陷	指甲凹陷
指痉症	指痉症
指端下陷	指端下陷
指端刺痛	指端刺痛
指端发黑	指端发黑
指端坏疽	坏疽,指端坏疽
指端溃疡	指端溃疡
指端瘢痕	指端瘢痕
指端硬化	指端硬化
指端缺血	指端缺血
指端麻木	指端麻木
指节肿胀	指节肿胀
指骨间关节伸展	关节伸展,指骨伸展
指骨骨质有破坏	指骨破坏,骨质破坏
指鼻试验指鼻不准	指鼻不准,指鼻试验指鼻不准
指鼻试验阳性	指鼻试验阳性,指鼻不准
指（趾）甲肥厚浑浊	甲肥厚
指（趾）端发绀	发绀
挖耳时眩晕	眩晕
挤压伤	挤压伤
挤压外口时有脓血性分泌物排出	外口排出,分泌物排出
挤压瘘管排出干酪样坏死物	干酪样坏死,瘘管
挤压睾丸疼痛减轻或消失	睾丸痛,睾丸疼痛,睾丸消失,睾丸减轻
挤压腓肠肌疼痛减轻或消失	腓肠肌消失,腓肠肌痛,腓肠肌减轻,腓肠肌疼痛
挤压跟腱疼痛减轻或消失	跟腱减轻,跟腱痛,跟腱疼痛,跟腱消失
挤眉弄眼	挤眉弄眼
振动觉减退	振动觉减退,振动觉
振动觉异常	振动觉,振动觉异常
振动觉正常	振动觉
损伤平面以下弛缓性瘫痪	瘫痪,瘫
损伤平面以下感觉功能障碍	感觉障碍,损伤平面以下功能障碍,感觉功能障碍,损伤平面以下感觉功能障碍
损伤平面以下运动功能障碍	损伤平面以下运动功能障碍,运动功能障碍,损伤平面以下功能障碍,运动异常
掌指关节不能伸直	掌指关节屈曲,掌指关节不能伸直
掌指关节屈曲	掌指关节屈曲
掌指关节的半脱位	掌指关节半脱位
掌指关节过伸	掌指关节过伸
掌指缝近屈肌腱上皮肤出现三角形皱褶	上皮出现,肌腱出现,肌腱皱褶,上皮皱褶
掌横纹处痛性结节	掌横纹结节
掌跖红斑	掌跖红斑
掌跖脓疱	脓疱
掌骨髓腔增宽	掌骨髓腔增宽
排便不尽感	排便不尽感
排便习惯改变	排便习惯改变
排便后腹痛不缓解	腹痛
排便困难	排便障碍,排便困难
排便失禁	排便失禁
排便排气后腹痛缓解	腹痛,排便缓解,排气缓解
排便次数增多	排便次数增多
排便疼痛	排便疼痛
排便障碍	排便障碍
排出其他妊娠物	其他妊娠物排出
排出暗红色血便	血便
排出胎儿	排出胎儿
排出胚胎	排出胚胎
排出蛔虫	蛔虫排出
排出血性黏液样粪便	粪便黏液样
排卵期阴道出血	阴道出血
排尿不尽	排尿不尽
排尿不尽感	排尿不尽感,排尿不尽
排尿不畅	排尿不畅,排尿异常
排尿不适	排尿不适
排尿中断	排尿中断
排尿剧痛	尿痛,排尿剧痛
排尿后腹部肿物消失	腹部消失,腹肿块,腹部肿物
排尿后膀胱区胀满感	膀胱区胀满感
排尿困难	排尿异常,排尿困难
排尿异常	排尿异常
排尿性晕厥	排尿性晕厥
排尿时哭闹不安	不安,哭闹
排尿次数减少	排尿次数减少,少尿
排尿灼热	排尿灼热
排尿烧灼感	排尿烧灼感
排尿痛	排尿痛,尿痛
排尿自行中断	排尿自行中断
排尿障碍	排尿障碍,排尿异常
排恶臭便	便恶臭
排气排便减少	排气减少,排气排便减少,排便减少
排粪造影检查时见到近端直肠套入远端直肠	排粪套入,直肠套入
排除妊娠	排除妊娠
接触刺激物后喘憋	憋喘,喘憋,刺激物接触
接触性出血	出血
接触性阴道流血	阴道出血,阴道流血
提睾反射减弱	提睾反射减弱
提睾反射消失	提睾反射消失,提睾反射缺失
提睾反射缺失	提睾反射缺失
握拳尺偏试验阳性	握拳尺偏试验阳性
握拳无力	握拳无力,无力
握拳试验阳性	握拳试验阳性
搏动性头痛	头痛
搏动性突眼	突眼
搏动性耳痛	耳痛
摇头	摇头
摔倒	摔倒
撅嘴	撅嘴
撅嘴吐舌	撅嘴,吐舌
撕裂样下腹痛	下腹痛,腹痛
撕裂样胸部剧痛	胸痛
擤鼻时眩晕	眩晕
支原体分离培养阳性	支原体分离培养阳性
支原体抗体明显增高	支原体抗体增高
支原体抗体阳性	支原体抗体阳性
支气管充气征	支气管充气征
支气管呼吸音	支气管呼吸音
支气管多形性腺瘤	腺瘤
支气管扩张	支气管扩张
支气管激发试验阳性	支气管激发试验阳性
支气管炎	支气管炎
支气管狭窄	支气管狭窄
支气管痉挛	痉挛,支气管痉挛
支气管结石	支气管结石
支气管舒张试验阳性	支气管舒张试验阳性
支气管运动激发试验阳性	激发试验阳性,支气管激发试验阳性
支气管黏液腺瘤	腺瘤
收缩压下降	收缩压下降
收缩压升高	收缩压升高
收缩压随心搏变化	心搏变化,收缩压变化
收缩早期喀喇音	收缩早期喀喇音
收缩期二尖瓣返流性杂音	收缩期杂音,二尖瓣杂音,心尖区收缩期杂音,心脏杂音
收缩期喀喇音	收缩早期喀喇音,收缩期喀喇音
收缩期早期喀喇音	收缩期喀喇音,收缩早期喀喇音
收缩期杂音	心尖区收缩期杂音,心脏杂音,收缩期杂音
收缩期震颤	收缩期震颤
改变体位腹痛加重	体位加重,体位改变,腹痛
改变体位诱发疼痛	体位改变,体位疼痛
攻击行动	攻击
放射性单腿痛	腿痛
斑丘疹	丘疹,斑丘疹
斜头畸形	斜头畸形,斜头
斜方肌无力	斜方肌无力
斜方肌萎缩	斜方肌萎缩,斜方肌无力
斜方肌麻痹	斜方肌无力,斜方肌麻痹
斜视	斜视
斜颈	斜颈
斧状脸	斧状脸
新发心绞痛	心绞痛
新旧皮疹同时存在	皮疹
新生儿产伤	新生儿产伤
新生儿外表呈过熟儿状态	外表呈过熟儿状态
新生儿外表有营养不良表现	外表表现,营养不良
方颅	方颅
旋转性眩晕	眩晕
旋转性眼震	眼震
无光感	无光感
无力	无力
无力提物	无力
无名指尺侧感觉障碍	感觉障碍,无名指障碍
无名指末节桡侧半背面感觉消失	无名指消失,感觉消失,末节消失,感觉障碍
无名指桡侧半掌面感觉减退	感觉障碍,掌面感觉消失,无名指减退,掌面减退,感觉减退
无名指桡侧半掌面感觉消失	掌面消失,感觉消失,无名指消失,感觉障碍,掌面感觉消失
无尿	无尿
无意义的单调怪声	单调怪声
无意识活动	无意识活动
无排气排便	无排气排便
无故发笑	无故发笑
无明确脑结构异常的伤后持续植物状态	植物状态
无汗	无汗
无法进食进水	进食无法,进水无法
无泪液	无泪液
无热惊厥	无热惊厥
无症状心包积液	心包积液,无症状
无症状性低血糖	低血糖
无症状性菌尿	无症状性菌尿
无痛性乳房肿块	乳房肿块
无痛性心肌梗死	心肌梗死,心肌梗塞
无痛性淋巴结肿大	淋巴结肿大
无痛性甲状腺肿	甲状腺肿大
无痛性皮下肿物	皮下肿物
无痛性突眼	突眼
无痛性肉眼血尿	血尿,肉眼血尿
无痛性角膜溃疡	角膜溃疡
无痛性阴道流血	阴道流血,阴道出血
无肝脾肿大	脾肿大,脾大
无胡须	无胡须
无脉	无脉
无舌苔	无舌苔
无色胶冻样痰	痰胶冻样,痰无色
无菌性脑膜炎	脑膜炎
无规律性的腹痛	腹痛
无醒前幻觉	幻觉
日常活动加剧头痛	活动加剧,头痛
日渐消瘦	消瘦,体重减轻
早产	早产
早孕反应	早孕反应
早孕反应消失	早孕反应,早孕反应消失
早搏后第二心音减弱	第二心音弱,早搏
早期血细菌培养阳性	早期血细菌培养阳性
早期表现为大便次数减少	大便次数表现,大便次数减少
早期较少出现体征	体征出现,体征较少
早期骨髓细菌培养阳性	早期骨髓细菌培养阳性
早泄	早泄
早饱	早饱
早饱感	早饱感,早饱
明显男性化者少见	男性化
昏厥	昏厥
昏睡	昏睡
昏迷	意识不清,昏迷,昏厥
昏迷进行性加重	昏迷,意识不清,昏厥
易倦	易倦
易冲动	易冲动
易变性痉挛	易变性痉挛
易哭	易哭
易怒	易怒,易激惹
易患肺炎	肺炎
易感染	易感染
易摔倒	易摔倒
易激动	易激动
易激怒	易激惹,易激怒
易激惹	易激惹
易疲乏	易疲乏,易倦
易疲倦	易疲倦,易倦
易疲劳	易疲劳,易倦
易跌倒	猝倒发作,易跌倒
易跌跤	易跌倒,易跌跤,猝倒发作
易跪倒	易跪倒
易醒	易醒
易饥	易饥
易饥饿	易饥饿,易饥
昼夜颠倒	昼夜颠倒
显著的凹陷性水肿	水肿
晕厥	晕厥
晚期痴呆表现	痴呆
晨僵	晨僵
晨起口干	口渴,口干
晨起呕吐	呕吐
晨起头痛	头痛
晨起对称双下肢无力	双下肢无力,无力,双下肢对称
晨起干咳	干咳,咳嗽
晨起恶心	恶心
晨起眼睑水肿	水肿,眼睑水肿
晨起血压高	血压高
晨轻暮重	晨轻暮重
晨醒头痛	头痛
晶状体半脱位	晶状体半脱位
智力下降	智力下降,智力减退
智力低下	智力低下
智力减退	智力减退,认知功能低下
智力发育不全	智力发育不全
智力发育低下	智力低下,发育障碍,智力发育低下
智力发育迟缓	智力迟缓,发育障碍,发育迟缓,智力发育迟缓
智力可减退	智力减退,认知功能低下
智力落后甚至退步	智力退步,智力低下
智力迟钝	智力迟钝
智力障碍	智力障碍
智能低下	智能低下,智力低下
智能减退	智能减退,智力减退
智能发育迟缓	智能发育迟缓,发育障碍,发育迟缓,智能迟缓
智能障碍	智力低下,智能障碍
暂时性失语	失语
暂时性心尖部收缩期杂音	心脏杂音,心尖部收缩期杂音,心尖部杂音,心尖区收缩期杂音,收缩期杂音
暂时性皮质盲	皮质盲
暗光中视物不清	视物不清,视力差
暗红色大便	大便暗红色
暗绿色便	便暗绿色
最后双手攀附下肢缓慢地站立	下肢缓慢,双手缓慢,双手攀附,下肢攀附
月经不再来潮	无月经,月经不再来潮
月经不规则	月经异常,月经不规则
月经不规律	月经异常,月经不规律
月经不调	月经异常,月经不调
月经减少	经量减少,月经异常
月经周期对肿块大小无影响	月经周期规则
月经周期延迟	月经周期延迟,月经异常
月经周期紊乱	月经异常,月经周期紊乱
月经周期缩短	月经异常,月经周期缩短
月经增多	经量增多,月经异常
月经失调	月经失调,月经异常
月经延迟	月经异常,月经延迟
月经异常	月经异常
月经未来潮	停经,未来潮
月经淋漓不尽	月经淋漓不尽,月经异常
月经稀发	月经异常,月经稀发
月经稀少	月经异常,月经稀少
月经紊乱	月经异常,月经紊乱
月经过少	经量过少,月经过少,月经异常
月经量多	月经异常,月经量多
月经间期出血	月经间期出血
月骨区压痛	月骨区压痛
月骨碎裂	月骨碎裂
月骨部位呈持续性疼痛	部位疼痛
月骨骨小梁不规则	月骨骨小梁不规则
有中间清醒期（好转期）的意识障碍	意识障碍,意识不清
有先兆流产症状	先兆流产
服胃炎药物无效	胃炎
朗格汉斯细胞浸润	朗格汉斯细胞浸润
期前收缩	期前收缩,房性期前收缩
木僵	木僵
未成熟中性粒细胞/中性粒细胞（I/T比率）≥0.16	中性粒细胞降低,中性粒细胞减少
末指节屈曲	末指节屈曲
末梢部位发绀	发绀,末梢部位发绀
末端指节不受累	指节不受累
末端瘫痪	瘫痪,瘫
术后创面渗血不止	创面不止,出血不止
杀婴倾向	杀婴倾向
束带状胸痛	胸痛
杨梅舌	杨梅舌
杵状指	杵状指
杵状指(趾)	杵状指
杵状指（趾）	杵状指
杵状趾	杵状趾
板状腹	腹板状
极度口渴	口渴
极度贪食	贪食
极易疲劳	疲惫,疲劳
构象障碍	构象障碍
构音不清	构音障碍,构音不清,失语
构音困难	构音困难,构音障碍
构音障碍	失语,构音障碍
构音障碍—手笨拙综合征	构音障碍—手笨拙综合征
枕后位	枕后位,胎方位
枕后发际较低	枕后发际较低,发际低,枕后较低
枕后部疼痛	枕后疼痛
枕墙距＞0	枕墙距＞0
枕横位	枕横位,胎方位
枕秃	枕秃
枕部淋巴结肿大	枕部肿大,淋巴结肿大,枕部淋巴结肿大
枕部疼痛	枕部痛,枕部疼痛
枕部痛	枕部疼痛,枕部痛
果酱样腥臭便	便腥臭,便果酱样
果酱样血便	血便
柏油样便	黑便,柏油样便
核左移	核左移
核左移伴中毒颗粒	核左移
核间性眼肌麻痹	核间性眼肌麻痹
桡侧三个手指端疼痛	手痛,手疼痛,指端疼痛,手指痛
桡侧三个手指端麻木	手麻木,指端麻木
桡侧腕屈肌腱囊性肿块	肌腱肿块
桡动脉搏动不能扪及	桡动脉搏动不能扪及
桡动脉搏动减弱	桡动脉搏动减弱
桡动脉搏动增强	桡动脉搏动增强
桡动脉搏动存在	桡动脉搏动存在
桡动脉搏动微弱	桡动脉搏动微弱
桡动脉搏动消失	桡动脉搏动消失
桡动脉触诊条索感	触诊条索感,桡动脉触诊条索感,桡动脉条索感
桡骨茎突压痛	桡骨茎突压痛
桡骨茎突痛性结节	桡骨茎突结节
桡骨茎突部位压痛	桡骨茎突部位压痛,部位压痛,桡骨茎突压痛
桡骨茎突部位疼痛	桡骨茎突疼痛,桡骨茎突部位疼痛,部位疼痛
桡骨远端掌侧关节面骨折	骨折,桡骨骨折
桶状胸	桶状胸
梅毒天疱疮	天疱疮,梅毒
梗阻症状	症状梗阻
梳头困难	梳头困难
棕红色果酱样痰	痰果酱样
棕褐色粘稠血便	血便
棕黄色斑丘疹	斑丘疹,丘疹
棕黄色皮疹	皮疹
棘突间压痛	棘突间压痛
植物状态	植物状态
椎一基底动脉供血不足症状	症状供血不足,动脉供血不足
椎体前缘虫蚀样变	椎体虫蚀样
椎体外系损伤症状	症状损伤,椎体损伤
椎体外系改变	椎体改变
椎体外系症状	椎体外系症状
椎体束征	椎体束征
椎体破坏	椎体破坏
椎间盘疼痛	椎间盘疼痛
椎间盘脱出	椎间盘脱出
椎间隙变窄	椎间隙变窄
欣快	欣快
欣快感	欣快感,欣快
欣快激动	欣快,欣快激动
止血不易	止血不易
步基增宽	步基增宽
步态不稳	步态障碍,步态不稳
步态共济失调	共济失调,步态共济失调
步态异常	步态障碍,步态异常
步态蹒跚	蹒跚步态,步态蹒跚
步态障碍	步态障碍
步行障碍	步行障碍
残根牙	牙残根
毛发变白	毛发变白
毛发干	毛发干枯,毛发干
毛发干枯	毛发干枯
毛发无光泽	毛发无光泽
毛发易脱落	毛发易脱落
毛发稀疏	毛发稀疏
毛发稀疏干燥	毛发稀疏,毛发干枯
毛发粗	毛发粗
毛发粗硬	毛发粗硬
毛发纤细	毛发纤细
毛发脱落	毛发脱落
毛发黄色	毛发黄色
毛囊丘疹	毛囊丘疹,皮疹
毛囊性炎症性丘疹	丘疹,皮疹
毛囊炎	毛囊炎
毛囊角化	毛囊角化
毛囊过度角化	毛囊角化
毛细血管充盈时间延长	毛细血管延长,毛细血管充盈时间延长
毛细血管搏动征	毛细血管搏动征,毛细血管搏动,周围血管征阳性
毛细血管搏动征阳性	毛细血管搏动征阳性,毛细血管搏动征,周围血管征阳性,毛细血管搏动
气促	呼吸困难,呼吸频率增快,气促
气味恐怖	气味恐怖
气囊肿吸气时缩小	吸气缩小,气囊肿
气急	气急,气促
气短	气短,呼吸困难,呼吸频率增快,气促
气管受压	气管受压
气管向健侧移位	气管移位
气管向患侧移位	气管移位
气管弯曲	气管弯曲
气管移位	气管移位
气管空隙小	气管空隙小
气管肿物	气管肿物
气胸	气胸
气胸线	气胸
气腹征	气腹征
氮质血症	氮质血症
水冲脉	水冲脉,周围血管征阳性
水平性眼球震颤	眼球震颤
水平眼震	眼震
水平翻转试验左右转头导致向地性眼震	眼震
水平翻转试验左右转头导致眩晕发作	眩晕
水样便	水样便,稀便
水样腹泻	腹泻
水泡音	水泡音
水牛背	水牛背
水电解质紊乱	水电解质紊乱,电解质紊乱
水疱	水疱
水疱成群聚集	水疱
水疱易破溃	水疱
水疱结痂	水疱,水疱结痂
水痘-带状疱疹病毒感染	水痘-带状疱疹病毒感染
水盐代谢紊乱	代谢紊乱
水肿	水肿
永久性失明	失明
汗液减少	汗液减少
汗液有鼠尿味	汗液鼠尿味
汗闭	汗闭
沉默	沉默
沉默寡言	沉默寡言
沿外周神经分布的疱疹	疱疹
泌乳	泌乳
泌尿生殖系统异常	泌尿生殖系统异常
泌尿系结石	泌尿系结石
泌尿系统梗阻症状	泌尿系统梗阻症状
泌尿系统症状	泌尿系统症状
泌尿系肿块	泌尿系肿块
泌尿道感染	泌尿道感染
泌汗功能障碍	泌汗障碍,泌汗功能障碍
泌汗障碍	泌汗障碍
泛酸	泛酸
波动性认知功能障碍	认知功能障碍
波动性认知障碍	认知功能障碍,认知障碍
波动性高尿酸血症	高尿酸血症
波动性黄疸	黄疸
波状热	波状热
注意力下降	注意力缺陷,注意力下降
注意力不易集中	注意力不易集中,注意力缺陷,注意力不集中
注意力不集中	注意力缺陷,注意力不集中
注意力减退	注意力减退,注意力缺陷
注意力分散	注意力缺陷,注意力分散,注意力不集中
注意力受损	注意力缺陷,注意力受损
注意力损害	注意力损害,注意力缺陷
注意力涣散	注意力不集中,注意力缺陷,注意力涣散
注意力缺失	注意力缺陷,注意力缺失
注意力缺陷	注意力缺陷
注意力障碍	注意力障碍
活动上臂时肩关节疼痛	关节痛,关节疼痛
活动减少	活动减少
活动后咳嗽	咳嗽,活动后咳嗽
活动后心悸	活动后心悸,心悸
活动后心绞痛	活动后心绞痛,心绞痛
活动后气促	气促,活动后气促,呼吸频率增快,呼吸困难
活动后气急	活动后气急,气促,气急
活动后气短	呼吸频率增快,活动后气短,活动障碍,气短,呼吸困难,气促
活动后痛性肌肉痉挛	痉挛,肌肉痉挛
活动后腰背痛减轻	腰背痛
活动困难	活动困难
活动性呼吸困难	气促,呼吸困难
活动时呼吸困难	气促,呼吸困难
活动时晕厥	晕厥
活动时气促	呼吸频率增快,呼吸困难,气促
活动时气短	呼吸频率增快,呼吸困难,气短,气促
活动耐力下降	活动耐力下降,活动耐量下降
活动耐力差	活动耐力差,活动障碍
活动耐量下降	活动耐量下降
活动耐量减低	活动耐量减低,活动耐量下降
活动耐量差	活动耐量差
活动肩部疼痛加重	活动加重,活动疼痛,肩部加重,肩部疼痛,肩痛
活动腕关节疼痛加重	关节痛,腕关节疼痛,关节疼痛,活动加重,腕痛
活动过多	活动过多
活动障碍	活动障碍
活跃期停滞	产程异常,活跃期停滞
活跃期延长	产程异常,活跃期延长
流产	流产
流感嗜血杆菌阳性	流感嗜血杆菌阳性
流感病毒感染	流感病毒感染
流泪	流泪
流涎	流涎
流涕	流涕
流清水涕	流清水涕,流涕
浅感觉减退	浅感觉减退
浅感觉障碍	浅感觉障碍
浅表淋巴结压痛	浅表淋巴结压痛
浅表淋巴结肿大	浅表淋巴结肿大
浅表静脉曲张	静脉曲张
浅静脉曲张	静脉曲张
浓茶色尿	尿黄色,茶色尿,血尿
浮髌试验阳性	浮髌试验阳性,浮髌感
消化不良	消化不良
消化功能失常	消化功能失常
消化性溃疡	消化性溃疡
消化系统症状	消化系统症状
消化道出血	消化道出血
消化道感染	消化道感染,感染
消化道溃疡	消化道溃疡
消化道症状	消化道症状
消化道穿孔	消化道穿孔
消瘦	体重减轻,消瘦
消瘦乏力	体重减轻,消瘦,乏力
液气胸	液气胸
淀粉样变性	淀粉样变
淋巴水肿	淋巴水肿
淋巴管压痛	淋巴管压痛
淋巴细胞减少	淋巴细胞减少
淋巴细胞增多〔症〕	淋巴细胞增多
淋巴结不肿大	淋巴结不肿大
淋巴结压痛	淋巴结压痛,淋巴结疼痛
淋巴结周围软组织水肿	淋巴结水肿,软组织水肿
淋巴结肿大	淋巴结肿大
淡漠	情感障碍,淡漠
淡黄色鼻溢	鼻溢淡黄色
深反射减弱	深反射减弱
深反射消失	深反射消失
深反射迟钝	深反射迟钝
深吸气后呼吸困难症状消失	气促,呼吸困难,深吸气,症状消失
深吸气后症状消失	深吸气,症状消失
深呼吸时腹痛加重	腹痛
深呼吸疼痛加剧	深呼吸
深大呼吸	深大呼吸,呼吸困难
深感觉减弱/缺失	深感觉缺失,深感觉减弱
深感觉减退	深感觉减退
深感觉障碍	深感觉障碍
深昏迷	深昏迷
深浅感觉减退	深浅感觉减退
深部性交痛	性交痛,性交困难
混合性聋	聋
清晨关节剧痛	关节痛,关节剧痛
清晨关节痛	关节痛
清晨咳痰	咳痰
清晨头晕	头晕
清晨头痛	头痛
清晨血压高	血压高
清球蛋白比例倒置	清球蛋白比例倒置
清醒后完全遗忘睡行经过	清醒,遗忘
渐进性听力下降	听觉减退,听力下降
渐进性意识障碍	意识障碍,意识不清
渗透压降低	渗透压降低
温度觉异常	温度觉异常
温度降低时可缓解疼痛	温度疼痛,温度缓解,温度降低
游离肩	游离肩
游走性关节痛	关节痛
游走性多发性关节痛	关节痛
游走性大关节肿痛	关节痛,大关节痛
游走性皮下结节	皮下结节
湿啰音	湿啰音,肺部啰音,感染
湿疹	湿疹
湿疹样皮疹	湿疹,皮疹
湿罗音	肺部啰音,湿罗音,湿啰音
溃疡有软骨样硬度	软骨溃疡
溃疡病术后复发	溃疡病,溃疡
溢乳	溢乳
溢尿	溢尿
溢泪	溢泪
溶血性尿毒症综合征	溶血性尿毒症综合征
溶血性贫血	溶血性贫血
滑囊液检查可见尿酸钠结晶	尿酸结晶
滑车淋巴结肿大	淋巴结肿大,滑车肿大,滑车淋巴结肿大
满月脸	满月脸
漏斗胸	漏斗胸
潜伏期延长	产程异常,潜伏期延长
潜伏期早期延长	产程异常,潜伏期早期延长
激发试验阳性	激发试验阳性
激惹	易激惹,激惹
激惹征象	易激惹,激惹
濒死感	濒死感
灯塔征	灯塔征
炎性肠病	肠病
炎性腰背痛	腰背痛
炸破样血管杂音	血管杂音
点状猩红色皮疹	皮疹
烦渴	烦渴
烦躁	烦躁不安,烦躁
烦躁不安	烦躁不安
烦躁失眠	失眠,烦躁,烦躁不安
烦躁焦虑	烦躁不安,烦躁,焦虑,焦急
烧心	烧心
烧心感	烧心,烧心感
热水浴时视力下降加重	视力下降,视力差
热退后大量出汗	出汗
热退疹出	热退疹出
焦急	焦急
焦虑	焦急,焦虑
焦虑不安	焦虑不安,焦急
焦躁不安	焦躁,不安
爆发性出汗	出汗
爆裂音	爆裂音
爪形手	爪形手
牙关紧闭	牙关紧闭
牙痛	牙痛
牙釉质上小凹	牙釉质小凹
牙齿变黑	牙齿变黑
牙齿小片脱落	牙齿松动
牙齿早脱	牙齿松动,牙齿早脱
牙齿松动	牙齿松动
牙齿萌出延迟	牙齿萌出延迟
牙齿釉质易剥落	牙齿釉质易剥落
牙齿钙化不全	牙齿钙化不全
牙龈出血	牙龈出血
牙龈增生	牙龈增生
牙龈增生肿胀	牙龈增生肿胀,牙龈增生
牙龈肿胀	牙龈肿胀
牙龈铅线	牙龈铅线
牛肉样舌	牛肉样舌
特发性震颤	特发性震颤
特定体位或头位诱发头晕	头晕
特殊肥胖	肥胖
犬吠样咳嗽	咳嗽
狂躁	狂躁
独立行走后步态不稳	步态不稳,步态障碍
狭窄远端的动脉搏动减弱	动脉搏动减弱,动脉狭窄
狭窄远端的动脉搏动消失	猝死,动脉搏动狭窄,动脉搏动消失
狭窄部位闻及收缩期杂音	心脏杂音,部位狭窄,心尖区收缩期杂音,收缩期杂音
狼疮特异性皮疹	皮疹,狼疮
猖獗性龋齿	龋齿
猜疑	猜疑
猝倒	猝倒
猝倒发作	猝倒,猝倒发作
猝死	猝死
猝然跌倒	跌倒
猩红热样皮疹	猩红热,皮疹
猿手畸形	猿手畸形
玫瑰疹	玫瑰疹
环形红斑	红斑
环指尺侧半皮肤感觉异常	皮肤感觉异常,环指感觉异常
球结膜充血	眼红,球结膜充血,眼结膜充血
球结膜充血水肿	球结膜充血,眼结膜充血,眼红,眼球结膜水肿,球结膜水肿
球结膜水肿	眼球结膜水肿,球结膜水肿
球结膜血管扩张	血管扩张,球结膜血管扩张
理解力下降	理解力下降
瑞氏综合征	瑞氏综合征
瓣叶增厚、挛缩、腱索缩短	瓣叶增厚
甘油三酯增高	甘油三酯增高
甘油三酯降低	甘油三酯降低
生殖器不发育	生殖器不发育
生殖器周围小水疱	水疱,生殖器小
生殖器和肛周淡红色丘疹	皮疹,肛周丘疹,生殖器淡红色,肛周淡红色,生殖器丘疹
生殖器增大早熟症	生殖器增大
生殖器皮疹	皮疹
生殖器萎缩	生殖器萎缩
生殖道质地变软	质地变软
生活不能自理	生活不能自理
生理性黄疸期延长	黄疸期延长
生育能力低	生育能力低
生长停滞	生长停滞
生长加速	生长加速
生长发育落后	发育障碍,生长迟缓,生长发育落后
生长发育迟缓	发育障碍,生长发育迟缓,生长迟缓
生长发育障碍	生长发育障碍
生长激素降低	生长激素降低
生长缓慢	生长缓慢
生长落后	生长迟缓,生长落后,发育障碍
生长迟缓	发育障碍,生长迟缓
生长高大	生长高大
用力握拳后不能立即将手伸直	握拳将手伸直,握拳不能
用力握拳疼痛加重不能持物	握拳疼痛,握拳加重
甲下脓肿	脓肿
甲亢后出现甲减症状	症状出现,甲减,甲亢
甲亢性肌病	肌病,甲亢
甲亢治疗后肝功能可好转	甲亢
甲亢症状	甲亢
甲周红斑	甲周红斑
甲床下出血	甲床出血
甲床发绀	发绀,紫绀,甲床发绀
甲床毛细血管搏动	甲床搏动,甲床毛细血管搏动,毛细血管搏动
甲床粪染	甲床粪染
甲床苍白	贫血,甲床苍白
甲有横沟	甲有横沟
甲沟皮肤疼痛	甲沟疼痛,皮肤疼痛,甲沟皮肤疼痛,皮肤痛
甲沟皮肤红肿	甲沟皮肤红肿,皮肤肿胀,皮肤红肿,甲沟红肿
甲沟糜烂渗出	甲沟渗出,甲沟糜烂
甲沟红肿化脓	甲沟红肿,甲沟化脓
甲状旁腺肿瘤病史	甲状旁腺肿瘤
甲状腺B超提示甲状腺可肿大或结节	甲状腺结节,甲状腺肿大
甲状腺不肿大	甲状腺不肿大
甲状腺中度肿大	甲状腺肿大
甲状腺内肿块	甲状腺内肿块,甲状腺肿大
甲状腺功能亢进	甲状腺功能亢进
甲状腺功能亢进病史	甲状腺功能亢进
甲状腺功能减退	甲状腺功能减退
甲状腺功能减退症状	甲状腺功能减退症
甲状腺功能减退的表现	甲状腺功能减退
甲状腺功能减退表现	甲状腺功能减退
甲状腺功能异常	甲状腺功能异常
甲状腺区疼痛	甲状腺区疼痛
甲状腺单个结节	甲状腺结节
甲状腺单侧肿大	甲状腺肿大
甲状腺单发结节	甲状腺结节
甲状腺压痛	甲状腺压痛
甲状腺压迫邻近器官症状	邻近器官压迫,症状压迫,甲状腺压迫
甲状腺孤立结节	甲状腺孤立结节
甲状腺对称	甲状腺对称
甲状腺局部无血管杂音	甲状腺血管杂音
甲状腺弥漫性肿大	甲状腺肿大
甲状腺无疼痛	甲状腺无疼痛
甲状腺无痛性肿大	甲状腺肿大
甲状腺核素静态显像见热结节	甲状腺结节
甲状腺毒症表现	甲状腺毒症
甲状腺激素分泌增多	分泌增多
甲状腺炎	甲状腺炎
甲状腺疼痛	甲状腺疼痛
甲状腺素水平降低	甲状腺素水平降低
甲状腺素（T4）升高	甲状腺素升高
甲状腺细针穿刺抽出脓液	脓液
甲状腺结节	甲状腺结节
甲状腺结节迅速增大	甲状腺结节,甲状腺增大
甲状腺肿	甲状腺肿大,甲状腺肿
甲状腺肿块固定	甲状腺肿,甲状腺肿大
甲状腺肿块质硬	甲状腺肿,甲状腺肿大
甲状腺肿大	甲状腺肿大
甲状腺腺瘤肿块包膜完整	包膜肿块,包膜完整,甲状腺腺瘤
甲状腺萎缩	甲状腺萎缩
甲状腺血管杂音	甲状腺杂音,甲状腺血管杂音,血管杂音
甲状腺表面光滑	甲状腺表面光滑
甲状腺表面平滑	甲状腺表面平滑
甲状腺触及结节	甲状腺触及结节
甲状腺触及震颤	甲状腺触及震颤
甲状腺触痛	甲状腺触痛
甲状腺质地坚硬	甲状腺质地坚硬,甲状腺质地硬
甲状腺质地硬	甲状腺质地硬
甲状腺质地较硬	甲状腺质地较硬,甲状腺质地硬
甲状腺质地较软	甲状腺质地较软
甲状腺超声示甲状腺弥漫性肿大	甲状腺肿大
甲状腺轻度肿大	甲状腺肿大
甲状腺震颤	甲状腺震颤
甲肝抗体阳性	甲肝
甲胎蛋白升高	甲胎蛋白升高,甲胎蛋白增高
甲脱落	甲脱落
电解质紊乱	电解质紊乱
电轴右偏	电轴右偏
电轴左偏	电轴左偏
男孩乳房发育	男孩乳房发育
男孩假两性畸形	假两性畸形
男孩假性性早熟	性早熟
男孩外生殖器女性化	外生殖器女性化
男性乳房女性化	男性乳房女性化
男性乳腺增大	男性乳腺增大
男性假两性畸形	假两性畸形
男性勃起功能障碍	男性勃起功能障碍
男性化症状	男性化
男性性功能减退	性功能减退
男性性早熟	性早熟
男性特征减弱	男性特征减弱
男性生殖系肿块	阴囊肿胀,男性生殖系肿块
畏光	畏光
畏冷	畏冷
畏声	畏声
畏寒	畏冷,畏寒
畸形齿	齿畸形
疑虑	疑虑
疝块进入阴囊	疝块进入阴囊
疮口呈蜂窝状	疮口蜂窝状
疱疹	疱疹
疱疹或皮疹的基底层组织液涂片找到天花病毒包涵体	疱疹,皮疹,天花
疱疹液抗原染色阳性	疱疹
疲乏	疲惫,疲乏
疲乏无力	乏力,疲乏无力,倦怠
疲倦	疲惫,疲倦
疲倦乏力	乏力,疲倦,疲惫
疲劳	疲劳,疲惫
疲劳乏力	乏力,疲劳,疲惫
疲劳感	疲劳感
疲惫	疲惫
疲软	疲软
疹退后皮肤糠麸样脱屑	皮肤脱屑,脱屑
疹退后皮肤色素沉着	皮肤色素沉着
疹退后脱屑	脱屑
疹退热退	疹退热退
疼痛反射至三角肌止点	三角肌疼痛,三角肌反射
疼痛可向右上腹及背部放射	背痛,背部放射
疼痛向下腹部放射	腹痛,腹部放射
疼痛向右肩背部放射	右肩放射,背部放射
疼痛向同侧腹股沟及会阴部放射	会阴部放射,会阴部疼痛,腹股沟疼痛,腹股沟放射
疼痛向肩胛部、颈、手放射	手痛,颈痛,手疼痛,肩胛痛,颈放射,手放射,肩胛疼痛,肩胛放射
疼痛向腰骶部放射	腰骶部放射,腰骶疼痛
疼痛向腹股沟放射	腹股沟疼痛,腹股沟放射
疼痛性跛行	跛行
疼痛放射到小腿	腿痛,小腿放射
疼痛放射到足部	足部放射,足部疼痛,足痛
疼痛放射至大腿后外侧	腿痛,大腿放射
疼痛放射至大腿后方	大腿放射,腿痛
疼痛放射至肩背部	肩放射,背痛,背部放射,肩痛
疼痛放射至腹部	腹痛,腹部放射
疼痛放射至臀部	臀部放射,臀部疼痛
疼痛放射至骶尾部	骶尾部放射,骶尾部疼痛,骶尾部痛
疼痛沿大动脉走行方向传导和转移	大动脉疼痛,大动脉转移
疼痛沿肋间分布	肋间痛,胸痛
疼痛沿输尿管放射	输尿管放射,输尿管疼痛
病侧眼球内陷	眼球凹陷,眼球内陷
病变以下感觉障碍	感觉障碍
病态疲劳	疲惫,病态疲劳,疲劳
病毒感染	病毒感染
病灶对侧偏瘫	偏瘫
病灶对侧凝视麻痹	凝视麻痹,凝视
病理反射	病理反射
病理反射阳性	病理反射阳性,病理反射
病理征阳性	病理征,病理征阳性
病理性缩复环形成	子宫收缩异常,病理性缩复环形成,病理性缩复环
病理性骨折	骨折
病理检查组织坏死	病理检查组织坏死,组织坏死
病肾增大	病肾增大
症状出现于月经前1~2周	症状出现
症状出现在月经前7～14天	症状出现
症状可随体位改变而减轻	体位减轻,体位改变,症状改变,症状不明显
症状周期性反复出现	症状出现
症状最晚在月经开始后4天内消失	症状消失
痉挛	痉挛
痉挛性一侧下腹痛	腹痛,下腹痛
痉挛性咳嗽	咳嗽
痉挛性截瘫	截瘫
痉挛性斜颈	痉挛性斜颈
痉挛性瘫痪	瘫痪,瘫
痉挛性腹痛	腹痛
痒感皮疹	皮疹
痔块呈环状脱出肛门外	肛门环状,痔块脱出,痔块环状,肛门脱出
痔块脱出呈梅花状	痔块梅花状,痔块脱出
痛性痉挛	痉挛
痛性跛行	跛行
痛温觉减退	痛温觉减退
痛温觉减退/消失	痛温觉消失,痛温觉减退
痛经	痛经
痛经进行性加重	痛经
痛觉减退	痛觉减退
痛觉过敏	痛觉过敏
痛觉障碍	痛觉障碍
痛风石	痛风石
痢疾	痢疾
痤疮	痤疮
痰中带血	痰中带血,咳血痰
痰中带血丝	咳血痰,痰中带血丝
痰含铁血黄素细胞阳性	铁血黄素细胞阳性,痰阳性
痰嗜酸细胞增多	痰嗜酸细胞增多
痰培养曲霉菌阳性	痰培养阳性,痰培养曲霉菌
痰培养肺炎链球菌阳性	痰培养肺炎链球菌阳性
痰培养葡萄球菌阳性	痰培养阳性
痰培养见白色念珠菌生长	真菌培养念珠菌生长
痰培养铜绿假单胞菌阳性	痰培养阳性
痰培养阳性	痰培养阳性
痰少	痰少
痰结核菌阳性	痰阳性
痰量增多	痰量增多
痰鸣音	痰鸣音,湿啰音
痴呆	痴呆
痴呆木僵	木僵,痴呆
瘘口两侧粗糙连续的血管杂音	血管杂音,血管粗糙
瘘管试验阳性	瘘管试验阳性
瘙痒感	瘙痒,瘙痒感
瘫痪	瘫痪,瘫
癫痫	癫痫
癫痫发作	癫痫,癫痫发作
癫痫发生率较低	癫痫
癫痫型	癫痫
癫痫大发作	癫痫大发作,癫痫
癫痫持续状态	癫痫持续状态
癫痫样全身抽搐	全身抽搐,全身癫痫样
白内障	白内障
白反射	白反射
白喉杆菌培养阳性	白喉
白天嗜睡	意识不清,嗜睡
白天睡眠发作	睡眠发作
白天睡眠过多	睡眠过多
白天突然进入睡眠	突然进入睡眠
白天频繁小睡	频繁小睡
白带增多	白带过多,白带增多
白带异常	阴道分泌物异常,白带异常
白带有血丝	白带血丝
白带稠厚	白带稠厚,阴道分泌物异常
白带过多	白带过多
白癜风	白癜风
白细胞减少	白细胞减少
白细胞增多	白细胞增高,白细胞增多
白细胞增高	白细胞增高,白细胞增多
白细胞总数增多	白细胞总数增高,白细胞总数增多
白细胞总数增高	白细胞总数增多,白细胞总数增高
白细胞计数减少	白细胞计数减少,白细胞计数降低
白细胞计数增加	白细胞计数增加,白细胞计数增高,血白细胞升高,白细胞计数升高,白细胞计数增多
白细胞计数增多	白细胞计数增加,白细胞计数增高,白细胞计数增多,血白细胞升高,白细胞计数升高
白细胞计数增高	白细胞计数增高,白细胞计数增多,血白细胞升高,白细胞计数升高,白细胞计数增加
白色泡沫黏痰	泡沫痰,咳痰,白色泡沫黏痰
白色粘液痰	咳痰,黏痰,白色粘液痰
白色陶土样大便	大便陶土样,大便白色
白蛋白与球蛋白比值降低	球蛋白降低
白蛋白降低	白蛋白降低
白陶土色便	便陶土色,便白
百日咳杆菌阳性	百日咳
皮下出血	皮下出血
皮下出血点	皮下出血点
皮下气肿	皮下气肿
皮下水肿	皮下水肿
皮下疏松组织处水肿	皮下水肿,组织疏松,皮下疏松,组织水肿
皮下瘀斑	皮下瘀斑
皮下组织松弛	皮下组织松弛
皮下结节	皮下结节
皮下脂肪组织消失	脂肪组织缺少,皮下消失,皮下脂肪组织消失
皮下脂肪组织萎缩	脂肪组织萎缩,皮下萎缩,皮下脂肪组织萎缩
皮下血肿	血肿
皮下黏膜出血点	皮下黏膜出血点,黏膜出血点,皮下出血点
皮损中央红肿明显	皮损
皮损分泌物中有大量梅毒螺旋体	分泌物大量,皮损,梅毒
皮损呈“薄膜现象”	皮损
皮损呈“蜡滴现象”	皮损
皮损呈圆形	皮损,皮损呈圆形
皮损呈椭圆形	皮损
皮损基底部硬如软骨	皮损
皮损处紧张发亮	皮损
皮损带状排列	皮损带状排列,皮损
皮损结痂	皮损结痂,皮损
皮损表面光滑	皮损,皮损表面光滑
皮损表面紧张发亮	表面发亮,皮损,表面紧张
皮温低	皮温低
皮温升高	皮温升高
皮温异常	皮温异常
皮炎	皮炎
皮疹	皮疹
皮疹一天出齐	皮疹
皮疹以头面部躯干为主	皮疹
皮疹呈向心性分布	皮疹
皮疹次日开始消退	皮疹
皮疹消退无脱屑	皮疹
皮疹消退无色素沉着	皮疹
皮疹瘙痒	皮疹
皮疹脱痂后留白班或色素沉着	皮疹
皮肤/手指苍白	皮肤苍白,手指苍白
皮肤“木板样”硬	皮肤硬,皮肤木板样
皮肤不易提起	皮肤不易提起
皮肤丘疱疹簇状分布	疱疹,皮肤疱疹
皮肤丘疹	皮肤丘疹,皮疹
皮肤亮	皮肤亮
皮肤光滑变薄	皮肤光滑,皮肤变薄
皮肤冷	皮肤冷
皮肤出冷汗	皮肤出冷汗,出冷汗
皮肤出血	皮肤出血
皮肤出血点	皮肤出血点
皮肤发红	皮肤发红,皮肤红
皮肤发绀	发绀,皮肤发绀
皮肤发花	皮肤发花
皮肤发黑	皮肤发黑
皮肤变冷	皮肤变冷
皮肤变厚	皮肤变厚
皮肤变薄	皮肤变薄
皮肤呈蜡黄色	皮肤蜡黄色
皮肤呈金黄色	皮肤金黄色
皮肤增厚	皮肤增厚
皮肤多形性红斑样损害	皮肤红斑样,皮肤损害
皮肤多汗	皮肤多汗,多汗
皮肤大片瘀斑	皮肤大块瘀斑,皮肤大片瘀斑
皮肤干枯	皮肤干燥,皮肤弹性差,皮肤干枯
皮肤干热	皮肤干热
皮肤干燥	皮肤干枯,皮肤干燥,皮肤弹性差
皮肤干燥伴弹性减退	皮肤减退,皮肤弹性差,皮肤干枯,皮肤干燥
皮肤干燥冰冷	皮肤弹性差,皮肤干枯,皮肤干燥
皮肤广泛出血	皮肤出血
皮肤广泛发绀坏死	发绀,皮肤坏死,皮肤发绀
皮肤广泛瘀斑	皮肤出血点,皮肤瘀斑
皮肤异常毛细血管团	皮肤异常,毛细血管团异常,皮肤异常毛细血管团
皮肤弥漫性潮红	皮肤潮红,皮肤红
皮肤弹性减退	皮肤弹性减退
皮肤弹性差	皮肤弹性差
皮肤弹性降低	皮肤弹性降低,皮肤弹性差,皮肤弹性减退
皮肤感觉异常	皮肤感觉异常
皮肤抓痕	皮肤抓痕
皮肤损害	皮肤损害
皮肤斑丘疹	丘疹,皮肤斑丘疹,斑丘疹
皮肤斑块	皮肤斑块
皮肤斑疹	皮肤斑疹
皮肤斑纹	皮肤斑纹
皮肤无汗	无汗,皮肤无汗
皮肤条行触痛带	皮肤压痛,皮肤触痛
皮肤松弛大疱	皮肤松弛
皮肤棕黄色斑	皮肤斑
皮肤毛发色素减退	皮肤减退,色素减少,毛发色素减退,皮肤色素减退
皮肤水疱	皮肤水疱,水疱
皮肤水肿	皮肤肿胀,皮肤水肿
皮肤汗多	皮肤汗多
皮肤油质感	皮肤油质感
皮肤波动感	皮肤波动感
皮肤浸润性斑块	皮肤斑块
皮肤深部感染	皮肤感染
皮肤深部血肿	血肿
皮肤温度低	皮肤温度低
皮肤温度较健侧低	皮肤温度低
皮肤温度高	皮温高,皮肤温度高
皮肤湿冷	皮肤湿冷
皮肤溃疡	皮肤溃疡
皮肤潮湿	皮肤潮湿
皮肤潮红	皮肤红,皮肤潮红
皮肤灼热痛	皮肤疼痛,皮肤痛
皮肤牛奶咖啡斑	牛奶咖啡斑,皮肤牛奶咖啡斑
皮肤疖肿	皮肤疖肿
皮肤疣状增生	皮肤疣状增生
皮肤疱疹	皮肤疱疹,疱疹
皮肤疼痛	皮肤疼痛,皮肤痛
皮肤病损	皮肤病损
皮肤瘀斑	皮肤出血点,皮肤瘀斑
皮肤瘀斑或瘀点	皮肤瘀斑,皮肤瘀点,皮肤出血点
皮肤瘀点	皮肤瘀点,皮肤出血点,皮肤瘀斑
皮肤瘙痒	皮肤瘙痒
皮肤白斑	皮肤白斑
皮肤皱缩	皮肤皱缩
皮肤皱褶处糜烂	皮肤皱褶糜烂
皮肤皱褶处红斑	皮肤皱褶红斑
皮肤皲裂	皮肤皲裂
皮肤破溃	皮肤破溃
皮肤硬皮病样改变	硬皮病,皮肤改变,硬皮
皮肤硬肿	皮肤硬肿
皮肤神经痛	皮肤神经痛
皮肤粗厚	皮肤粗厚
皮肤粗糙	皮肤粗糙
皮肤粘膜出血	皮肤出血,粘膜出血
皮肤粘膜呈樱桃红色	皮肤粘膜樱桃红色,粘膜樱桃红色,皮肤樱桃红色
皮肤粘膜干燥	粘膜干燥,皮肤粘膜干燥,皮肤弹性差,皮肤干枯,皮肤干燥
皮肤粘膜樱桃红色	皮肤粘膜樱桃红色,粘膜樱桃红色,皮肤樱桃红色
皮肤粘膜淤点	粘膜淤点,皮肤瘀斑
皮肤粪染	皮肤粪染
皮肤糜烂	皮肤糜烂
皮肤糠状鳞屑	脱皮,皮肤鳞屑
皮肤紧硬	皮肤紧硬
皮肤紫兰色结节	皮肤结节,皮肤紫兰色
皮肤紫癜	紫癜
皮肤紫纹	皮肤紫纹
皮肤红斑	皮肤红斑
皮肤红紫	皮肤红紫
皮肤红肿	皮肤肿胀,皮肤红肿
皮肤红肿热痛	皮肤疼痛,皮肤痛
皮肤红色按压后可暂时消失	皮肤消失,皮肤红色,皮肤按压
皮肤红色点状疱丘疹奇痒	奇痒,皮肤红色,皮疹,皮肤丘疹
皮肤细小瘀点	皮肤出血点,皮肤瘀斑,皮肤瘀点,皮肤细小
皮肤细网格状红肿中央棕黄色	皮肤肿胀,皮肤红肿
皮肤细腻	皮肤细腻
皮肤结节	皮肤结节
皮肤结节性红斑	皮肤红斑
皮肤肥厚	皮肤肥厚
皮肤肿块	皮肤肿块,皮肤肿胀
皮肤肿物	皮肤肿胀,皮肤肿物
皮肤肿胀	皮肤肿胀
皮肤脓疱	脓疱
皮肤脓疱干缩结痂	皮肤结痂,脓疱
皮肤脓疱疮	脓疱
皮肤脱屑	脱屑,皮肤脱屑
皮肤脱皮屑	皮肤脱皮屑
皮肤膜状脱皮	脱皮
皮肤色素减退	皮肤色素减退,色素减少
皮肤色素沉着	皮肤色素沉着
皮肤色素痣多	痣
皮肤色素脱失	皮肤色素脱失
皮肤花纹	皮肤花纹
皮肤苍白	皮肤苍白
皮肤苔藓样变	苔藓样变,皮肤苔藓样变
皮肤菲薄	皮肤菲薄
皮肤菲薄极易破损	皮肤极易,皮肤菲薄,皮肤破损
皮肤萎缩	皮肤萎缩
皮肤营养障碍	营养不良,营养障碍
皮肤薄	皮肤薄
皮肤血斑	皮肤血斑
皮肤血肿	血肿
皮肤表面如大理石样斑纹	表面大理石样斑,皮肤大理石样斑
皮肤表面粗糙	皮肤表面粗糙
皮肤角化	皮肤角化
皮肤触痛	皮肤压痛,皮肤触痛
皮肤轻度淤血	皮肤淤血
皮肤过敏	皮肤过敏,有过敏史
皮肤非可凹性肿胀	皮肤非可凹性肿胀,非可凹性肿胀
皮肤颜色加深	皮肤颜色加深
皮肤鳞屑	皮肤鳞屑,脱皮
皮肤麻木	皮肤麻木,皮肤麻
皮肤黄染	黄疸,皮肤黄染
皮肤黏膜出血	皮肤黏膜出血,黏膜出血
皮肤黏膜干燥	皮肤弹性差,皮肤干燥,皮肤黏膜干燥
皮肤黏膜灼伤	皮肤黏膜灼伤
皮肤黏膜色素沉着	皮肤黏膜色素沉着
皮肤黏膜苍白	皮肤黏膜苍白
皮肤黏膜黄染	皮肤黏膜黄染
皮脂分泌减少	皮脂分泌减少
皮脂腺瘤	皮脂腺瘤
皮质下失语	失语
皮质盲	皮质盲
皮质聋	皮质聋
皱眉	皱眉
盆腔原存在的肿块变小	盆腔肿块,盆腔变小
盆腔原存在的肿块消失	盆腔消失,盆腔肿块
盆腔后部空虚	盆腔空虚
盆腔检查扪及与子宫粘连的囊性肿块	盆腔扪及,子宫粘连,盆腔肿块
盆腔淋巴结肿大	盆腔肿大,淋巴结肿大,盆腔淋巴结肿大
盆腔疼痛	盆腔痛,盆腔疼痛
盆腔痛	盆腔痛,盆腔疼痛
盆腔肿块	盆腔肿块
盆腔触痛性结节	盆腔结节
盗汗	盗汗
盘状红斑	红斑
直接对光反射消失	对光反射消失,直接对光反射消失
直接对光反射迟钝	对光反射迟钝,直接对光反射迟钝
直立倾斜试验阳性	直立倾斜试验阳性
直立性低血压	直立性低血压
直立时脊柱向患侧侧凸	脊柱侧凸
直肠下坠感	直肠下坠感
直肠内不适	直肠不适
直肠刺激症状	直肠刺激症状
直肠前凹肿块	直肠前凹肿块
直肠前壁触痛	直肠痛,直肠前壁触痛
直肠前壁饱满	直肠前壁饱满
直肠前方压痛	直肠痛
直肠前方血肿	血肿
直肠子宫陷凹可扪及触痛性结节	直肠子宫陷凹扪及,直肠子宫陷凹结节
直肠子宫陷凹结节	直肠子宫陷凹结节
直肠子宫陷凹肿块	直肠子宫陷凹肿块
直肠子宫陷凹脓肿	直肠子宫陷凹脓肿
直肠子宫陷凹触及质硬结节	直肠子宫陷凹质硬结节,直肠子宫陷凹触及
直肠子宫陷凹触及质硬肿块	直肠子宫陷凹肿块,直肠子宫陷凹质硬,直肠子宫陷凹触及
直肠指检发现前列腺结节	直肠指检结节,前列腺结节
直肠指检可有触痛	直肠指检触痛
直肠指检张力较高	直肠指检较高,直肠指检张力较高,张力较高
直肠指检直肠前壁触及直肠腔内膨出	直肠指检膨出,直肠触及,直肠膨出,直肠指检触及
直肠指检肛管括约肌松弛	直肠指检松弛,括约肌松弛,肛管松弛
直肠指检触到增大的前列腺	直肠指检增大,前列腺增大
直肠指检触及直肠前壁有饱满感	直肠指检饱满感,直肠指检触及
直肠指检触及粪石	直肠指检触及粪石
直肠指诊发现手指套染血	直肠指诊染血
直肠指诊发现癌肿	癌肿
直肠指诊发现直肠前壁向腔内膨起	直肠指诊膨起
直肠指诊发现直肠前壁有波动感肿物	直肠指诊肿块,直肠指诊波动感
直肠指诊发现直肠前壁有触痛肿物	直肠痛,直肠指诊触痛,直肠指诊肿块,直肠前壁触痛
直肠指诊发现直肠壶腹空虚	直肠指诊空虚,直肠壶腹空虚
直肠指诊发现粪便停留在扩张的结肠内	结肠扩张,粪便停留,直肠指诊停留,粪便扩张,直肠指诊扩张,结肠停留
直肠指诊发现肛管括约肌松弛	直肠指诊松弛,括约肌松弛,肛管松弛
直肠指诊可激发排便反射	排便反射,直肠指诊反射
直肠指诊引起剧烈疼痛	直肠指诊疼痛
直肠指诊时有大量恶臭气体溢出	直肠指诊大量,直肠指诊恶臭,直肠指诊溢出
直肠指诊时有大量恶臭粪液溢出	粪液溢出,直肠指诊大量,直肠指诊恶臭
直肠指诊直肠前壁压痛广泛	直肠指诊压痛,直肠痛
直肠指诊直肠前窝扪及肿块	直肠肿块,直肠指诊肿块,直肠扪及,直肠指诊扪及
直肠指诊直肠右前方压痛	直肠指诊压痛,直肠痛
直肠指诊触及痛性肿块	直肠指诊肿块,直肠指诊触及
直肠指诊触及直肠中下段息肉	直肠指诊触及,直肠指诊息肉,直肠触及,直肠息肉
直肠指诊退出手指时大量粪便和气体随之排出	粪便大量,直肠指诊排出,手指排出,直肠指诊大量,粪便排出,手指大量
直肠疼痛	直肠疼痛,直肠痛
直肠脱垂的黏膜糜烂破溃后有血液流出	血液糜烂,黏膜糜烂,直肠脱垂,血液破溃,黏膜流出,黏膜破溃,血液流出
直肠自主神经功能障碍	直肠功能障碍,自主神经障碍,自主神经功能障碍,直肠自主神经功能障碍
直肠阴道壁红肿	直肠肿块,直肠阴道壁红肿
直肠阴道壁缺如	直肠阴道壁缺如
直肠黏膜自肛门脱出	肛门脱出,黏膜脱出,直肠脱出
直腿抬高试验及加强试验阳性	直腿抬高加强试验阳性,直腿抬高阳性,加强试验阳性
直腿抬高试验阳性	直腿抬高阳性
直腿抬高超过60°时疼痛减轻	直腿抬高疼痛,直腿抬高减轻
相对缓脉	相对缓脉
盾胸	盾胸
眉弓突出	眉弓突出
眉弓高突	眉弓高突
真菌培养念珠菌阳性	真菌培养念珠菌生长,真菌培养阳性
真菌培养阳性	真菌培养阳性
眩晕	眩晕
眩晕伴有颈部疼痛	眩晕,颈痛,颈部疼痛
眩晕持续时间长	眩晕
眶上内缘隆起	眶上内缘隆起
眶上额部头痛	头痛,眶上额部头痛
眶上额部痛	眶上额部痛
眶内疼痛	眶内疼痛
眶后搏动性头痛	头痛
眶周水肿	眶周水肿
眶周皮肤感觉障碍	眶周障碍,眶周皮肤感觉障碍,皮肤感觉障碍
眶周皮肤萎缩	皮肤萎缩,眶周萎缩,眶周皮肤萎缩
眶周红斑	眶周红斑
眶周肿胀	眶周肿胀
眶尖综合征	眶尖综合征
眶底抬高	眶底抬高
眶缘变钝	眶缘变钝
眶缘饱满	眶缘饱满
眶顶部隆起	眶顶部隆起
眼位异常	眼位异常
眼内异物感	眼内异物感,异物感,眼内异物
眼分泌物增多	眼分泌物增多,分泌物增多
眼分泌物黏稠	眼分泌物黏稠
眼前发黑	眼前发黑
眼压升高	眼压升高,眼压增高
眼压增高	眼压升高,眼压增高
眼后部胀痛	眼胀,眼痛,眼胀痛
眼向病灶侧凝视	凝视
眼外肌麻痹	眼外肌麻痹
眼干	眼干
眼干涩	眼干涩
眼干燥不适	眼干
眼干燥症	眼干燥症,眼干
眼底充血	眼底充血,眼底出血
眼底出血	眼底出血
眼底出血、渗出	眼底出血,眼底渗出
眼底改变	眼底改变
眼底检查视盘水肿	视盘水肿
眼底樱桃红斑	眼底红斑,眼底樱桃
眼底渗出	眼底渗出
眼底玻璃体下片状出血	玻璃体出血,眼底出血
眼底絮状白斑	眼底白斑
眼底脉络膜结核结节	眼底结核,脉络膜结核,眼底结节,脉络膜结节
眼异物感	异物感,眼异物感
眼烧灼感	眼烧灼感
眼球“猫喘”样震颤	眼球震颤
眼球上翻/凝视	眼球上翻,凝视
眼球上视障碍	上视障碍,眼球上视障碍
眼球不同轴	眼球不同轴
眼球会聚障碍	眼球障碍
眼球偏斜	眼球偏斜
眼球内斜	眼球内斜
眼球内陷	眼球凹陷,眼球内陷
眼球凝视障碍	眼球障碍,凝视
眼球分离斜视	斜视,眼球分离
眼球后疼痛	眼球后疼痛
眼球向上下运动障碍	眼球运动障碍,运动异常,眼球运动受限
眼球固定	眼球固定
眼球活动受限	眼球活动受限
眼球活动障碍	眼球活动障碍
眼球浮动	眼球浮动
眼球深处钝痛	眼球钝痛
眼球疼痛	眼痛,眼球痛,眼球疼痛
眼球痛	眼球疼痛,眼痛,眼球痛
眼球移位	眼球移位
眼球突出	眼球突出
眼球转动时球后胀痛	眼球转动胀痛
眼球转动疼痛	眼球转动疼痛
眼球辐辏运动障碍	眼球运动障碍,运动异常,眼球运动受限
眼球过小	眼球过小
眼球运动受限	眼球受限,运动受限,眼球运动受限
眼球运动受限/固定	眼球固定,眼球受限,运动受限,眼球运动受限,运动固定
眼球运动异常	运动异常,眼球运动异常,眼球异常
眼球运动障碍	眼球运动受限,眼球运动障碍,运动异常
眼球震颤	眼球震颤
眼畏光	眼畏光,畏光
眼疲劳	眼疲劳,疲惫,疲劳
眼痛	眼痛
眼眶下陷	眼眶下陷,眼眶凹陷
眼眶凹陷	眼眶凹陷
眼眶变小	眼眶变小
眼眶宽	眼眶宽
眼眶痛	眼痛,眼眶痛
眼眶部压痛	眼眶部压痛,眼痛
眼睑上牵	眼睑上牵
眼睑下垂	眼睑下垂
眼睑充血	眼睑充血
眼睑外翻	眼睑外翻
眼睑水肿	水肿,眼睑水肿
眼睑沉重	眼睑沉重
眼睑痉挛	眼睑痉挛
眼睑皮肤红斑	皮肤红斑
眼睑肿胀	水肿,眼睑肿胀,眼睑水肿
眼睑退缩	眼睑退缩
眼睑部瘀斑	眼睑瘀斑
眼睑闭合不全	眼睑闭合不全
眼睑闭合无力	无力,眼睑闭合
眼睑闭合是露出巩膜	巩膜露出,眼睑露出,巩膜闭合,眼睑闭合
眼睑震颤	眼睑震颤
眼睛注视同侧	眼睛注视同侧
眼睛痒	眼睛痒
眼睛胀痛	眼睛胀痛
眼窝内陷	眼窝内陷,眼窝凹陷
眼窝凹陷	眼窝凹陷
眼红	眼红
眼结膜充血	眼结膜充血
眼结膜出血	眼结膜充血,出血,眼结膜出血
眼结膜疱疹	疱疹,眼结膜疱疹
眼肌不受累	眼肌不受累
眼肌无力	眼肌无力,无力
眼肌萎缩	肌萎缩,眼肌萎缩
眼肌麻痹	肌麻痹,眼肌麻痹
眼胀	眼胀
眼胀痛	眼胀,眼痛,眼胀痛
眼花	眼花
眼裂变小	眼裂变小
眼裂增宽	眼裂增宽
眼裂小	眼裂小
眼距增宽	眼距增宽,眼距宽
眼距宽	眼距宽
眼距异常	眼距异常
眼距过宽	眼距宽,眼距过宽
眼轮匝肌间歇性抽搐	眼抽搐,轮匝肌抽搐
眼部不适	眼部不适
眼部损害	眼部损害
眼部症状	眼部症状
眼阵挛	眼阵挛
眼震	眼震
睁眼无力	睁眼无力,无力
睑下垂	睑下垂
睑结膜乳头增生	睑结膜乳头增生
睑结膜苍白	睑结膜苍白
睑裂变小	睑裂变小
睡眠不安	睡眠不安
睡眠倒错	睡眠倒错,睡眠障碍
睡眠呼吸暂停	睡眠呼吸暂停
睡眠多动	睡眠多动,多动
睡眠改变	睡眠改变
睡眠时不自主肢体运动	睡眠不自主
睡眠时不自主运动消失	睡眠消失,不自主运动
睡眠瘫痪	瘫痪,瘫
睡眠缺失感	睡眠缺失
睡眠障碍	睡眠障碍
睾丸上移	睾丸上移
睾丸压痛	睾丸痛,睾丸压痛
睾丸及精索压痛	精索压痛,睾丸压痛,睾丸痛
睾丸变硬	睾丸变硬
睾丸变软	睾丸变软
睾丸增大	睾丸增大
睾丸小	睾丸小
睾丸局部肿大	睾丸肿大
睾丸无痛性肿大	睾丸肿大
睾丸无痛性质硬不规则形状包块	睾丸质硬,睾丸不规则,睾丸包块
睾丸无痛性质硬结节状包块	睾丸包块,睾丸质硬结节
睾丸松软缩小	睾丸变软,睾丸缩小
睾丸炎	睾丸炎
睾丸疼痛	睾丸疼痛,睾丸痛
睾丸疼痛性肿块	阴囊肿胀,睾丸肿块
睾丸硬结肿胀	睾丸肿胀,睾丸硬结
睾丸红肿	睾丸红肿
睾丸肿大疼痛	睾丸疼痛,睾丸肿大,睾丸痛
睾丸肿痛	睾丸痛,睾丸肿痛
睾丸肿胀	睾丸肿胀
睾丸萎缩	睾丸萎缩
睾丸触痛	睾丸触痛,睾丸痛
睾丸部坠痛	睾丸痛
睾丸部钝痛	睾丸钝痛
睾丸鞘膜积液	睾丸鞘膜积液
瞬目减少	瞬目减少
瞬目反射减少	瞬目反射,瞬目反射减少
瞳孔不等大	瞳孔不等大
瞳孔光反射消失	对光反射消失,瞳孔光反射消失
瞳孔大小不对称	瞳孔大小不对称
瞳孔大小不等	瞳孔不等大,瞳孔大小不等
瞳孔对光反射存在	瞳孔存在,瞳孔对光反射存在,对光反射存在
瞳孔对光反射消失	对光反射消失,瞳孔消失,瞳孔对光反射消失
瞳孔对光反应迟钝	瞳孔对光反应迟钝,对光反射迟钝
瞳孔对称缩小	瞳孔缩小,瞳孔对称
瞳孔异常	瞳孔异常
瞳孔忽大忽小	瞳孔忽大忽小
瞳孔扩大	瞳孔扩大,瞳孔放大
瞳孔改变	瞳孔变形,瞳孔改变
瞳孔散大	瞳孔放大,瞳孔散大
瞳孔的光反射减弱	光反射减弱,瞳孔减弱
瞳孔缩小	瞳孔缩小
瞳孔缩小且不规则	瞳孔缩小,瞳孔不规则
瞳孔调节反射存在	瞳孔调节反射存在
矛盾呼吸	矛盾呼吸
短促收缩期杂音	心尖区收缩期杂音,收缩期杂音,心脏杂音
短头畸形	短头,短头畸形
短时记忆缺失	短时记忆缺失,短时记忆
短暂性全面遗忘症	遗忘症,遗忘
短暂性共济失调	共济失调
短暂性失明	失明
短暂性昏厥	昏厥
短暂性肢体瘫痪	瘫,瘫痪
短暂性脑功能损害症状	脑功能损害,症状损害
短暂性脑缺血发作	短暂性脑缺血发作
短暂性视网膜功能障碍	视网膜功能障碍
短暂意识障碍	意识障碍,意识不清
短暂的意识丧失	意识不清,意识丧失
短臂侏儒症	侏儒症
短足畸形	短足,短足畸形
短颈	短颈
砖红色胶冻样痰	痰胶冻样,痰红色
破罐音	破罐音
硬下疳	硬下疳
硬化性淋巴细胞性小叶炎	淋巴细胞性小叶炎
硬化性淋巴结炎	淋巴结炎
硬腭隆起	硬腭隆起
硬腭高窄	硬腭高窄
碱性磷酸酶升高	碱性磷酸酶升高,碱性磷酸酶增高
碱性磷酸酶增高	碱性磷酸酶升高,碱性磷酸酶增高
磨牙	磨牙
示中指末节感觉消失	感觉障碍,示中指末节消失,示中指末节感觉消失,感觉消失
示指不能屈曲	示指不能屈曲
示指背侧近端感觉减退	近端感觉减退,示指减退
社会接触能力减退	社会接触能力减退
神志不清	神志不清,神志障碍
神志异常	神志障碍,神志异常
神志恍惚	恍惚,神志恍惚
神志改变	神志改变
神志模糊	神志障碍,神志模糊
神志淡漠	淡漠,神志障碍,神志淡漠,情感障碍
神志障碍	神志障碍
神情淡漠	淡漠,情感障碍,神情淡漠
神经分布区疼痛	神经分布区疼痛,神经痛,分布区疼痛
神经分布区麻木	分布区麻木,神经麻木,神经分布区麻木
神经功能缺失	神经功能缺失
神经功能障碍	神经功能障碍
神经反射迟钝	神经迟钝,神经反射
神经受损症状	神经受损症状
神经官能症	神经官能症
神经性耳聋	耳聋
神经性膀胱	神经性膀胱
神经损害	神经损害,神经损伤
神经根刺激症状	神经根刺激症状
神经根痛	神经根痛
神经源性膀胱	神经源性膀胱
神经症状	神经症状
神经精神症状	神经精神症状
神经系统发育异常	神经系统发育异常,发育异常
神经系统无其他阳性体征	神经系统无其他阳性体征
神经系统检查无阳性体征	神经系统检查无阳性体征
神经紊乱	神经紊乱
神经纤维瘤	纤维瘤
神经肌肉疼痛	神经肌肉痛,肌肉痛,神经肌肉疼痛,肌痛,神经痛,肌肉疼痛
神经营养性障碍	性障碍
神经血管性水肿	神经血管性水肿
神经衰弱	神经衰弱
神经质	神经质
禁水试验后尿量减少	尿少,尿量减少
秃顶	秃顶
秋水仙碱可以迅速缓解关节症状	秋水仙碱缓解,关节缓解,症状缓解
移动性浊音	腹水,移动性浊音,移动性浊音阳性
移动性浊音阳性	腹水,移动性浊音,移动性浊音阳性
移动性痉挛	痉挛
秽亵语言	秽亵语言
稀水样便	稀便,水样便
稀粪自行从肛门流出	稀粪,肛门流出
稀薄黄色水样白带	白带稀薄,白带黄色
稽留热	稽留热
空瓮音	空翁音,空瓮音
空腹时腹部振水音	腹部空腹,振水音
空腹胰岛素升高	空腹胰岛素升高
空腹血糖水平升高	空腹血糖升高,空腹血糖增高
空腹血糖（FPG）<7.0mmol/L	空腹血糖升高
空间定向障碍	空间定向障碍
穿刺可抽出透明微混浊的黄色稀薄液体	穿刺黄色液体
穿刺液皮内试验阳性	皮内试验阳性,穿刺阳性
穿衣困难	穿衣困难
突发上腹痛	上腹痛,腹痛
突发严重呼吸困难	呼吸困难,气促
突发剧烈上腹痛	上腹痛,腹痛
突发剧烈全头痛	头痛
突发剧烈腹痛	腹痛
突发剧烈腹部绞痛	腹部绞痛,腹痛
突发性眩晕	眩晕
突发性耳聋	耳聋
突发性腰痛	腰痛
突发持续性剧烈腹痛	腹痛
突发持续性腹痛绞痛	腹痛
突发持续无痛性血尿	血尿
突发无热惊厥	无热惊厥
突发胸痛	胸痛
突发胸闷	胸闷
突发腹痛	腹痛
突发腹部痉挛性疼痛	腹部疼痛,腹痛
突发髋关节疼痛	关节痛,髋痛,髋关节疼痛,关节疼痛
突然剧烈眩晕	眩晕
突然发生视力模糊	视力突然,视力障碍,视力模糊
突然晕厥	晕厥
突然肾功能下降	肾功能下降,肾功能突然
突然起立发生晕厥	晕厥
突然跌倒	跌倒
突眼	突眼
窒息	窒息
窒息感	窒息感
窦性停搏	窦性停搏
窦性心动过速	心律失常,窦性心动过速
窦房传导阻滞	窦房传导阻滞
窦道常年不愈	窦道不愈
窦道排出豆渣样脓液	脓液
竖毛障碍	竖毛障碍
站立不稳	站立不稳
站立时腰部前凸	腰部前凸
站立时臀部后耸	臀部后耸
站立时足距增宽	足距增宽
站立时骨盆前倾	骨盆前倾
站立行走困难	行走困难,站立行走困难,行为障碍,站立不稳
端坐呼吸	端坐呼吸
第1磨牙病变	第1磨牙病变
第1跖骨内收	跖骨内收
第1跖骨头突出部分皮肤增厚	头增厚,跖骨突出,皮肤增厚,跖骨增厚,皮肤突出,头突出
第2、3掌骨基部背侧唇样骨质增生	骨质增生
第2、3掌骨基部背侧局限性骨性隆起	掌骨隆起
第2前磨牙病变	第2前磨牙病变
第2磨牙病变	第2磨牙病变
第一心音亢进	第一心音亢进
第一心音低钝	心音减弱,心音低钝
第一心音减弱	第一心音减弱
第一心音分裂	第一心音分裂
第一心音增强	第一心音增强
第一心音强度减弱	第一心音强度减弱,强度减弱,第一心音减弱
第一心音强度变化	第一心音强度变化,强度变化,第一心音变化
第一心音强度变化不定	第一心音不定,强度变化,强度不定,第一心音变化,第一心音强度变化
第一心音强度经常变化	第一心音变化,第一心音强度变化,强度变化
第一心音强度逐渐减弱并有心搏脱漏	第一心音强度减弱,心搏脱漏,强度脱漏,强度减弱,第一心音脱漏,第一心音减弱,心脏搏动减弱
第一心音强弱不一	第一心音强弱不一
第一心音强弱不等	第一心音强弱不等
第一跖趾关节疼痛	关节痛,第一跖趾关节疼痛
第一跖趾关节肿痛	第一跖趾关节肿痛
第一跖趾关节肿胀	第一跖趾关节肿胀
第三心音	第三心音
第三心音奔马律	奔马律,心脏杂音,第三心音
第二产程停滞	第二产程停滞,产程异常
第二产程延长	第二产程延长,产程异常
第二心音分裂	第二心音分裂
第二心音反相分裂	第二心音分裂
第二心音响亮	第二心音响亮
第二心音固定分裂	第二心音固定分裂
第二心音持续性分裂	第二心音分裂
第二性征不发育	第二性征不发育,性发育落后
第二性征发育迟缓	发育障碍,发育迟缓,第二性征发育迟缓
第四心音	第四心音
第四心音奔马律	奔马律,第四心音,心脏杂音
筋膜室即肌腹处有压痛	筋膜室肌腹处,筋膜室压痛
管型尿	尿管型
管状呼吸音	呼吸音管状
类偏狂	类偏狂
类癌综合征	类癌综合征
类风湿结节	类风湿
粉红色泡沫痰	泡沫痰
粒细胞减少	粒细胞减少
粗湿罗音	湿罗音,湿啰音,肺部啰音
粗鲁行为	行为粗鲁
粘液便	粘液便
粘液性水肿	粘液性水肿
粘液脓血便	粘液脓血便,粘液便
粘液血便	粘液血便,粘液便
粘膜出血点	粘膜出血点,粘膜充血
粟粒性肺浸润	肺浸润
粟粒疹	粟粒疹
粪便中混有血	粪便中混有血,便中混有血,粪混有血,粪便有鲜血
粪便培养志贺菌阳性	粪便阳性
粪便干结	粪便干结
粪便性状改变	粪便性状改变
粪便恶臭	粪便恶臭
粪便有血块	粪便有血块,粪便有鲜血
粪便有鲜血	粪便有鲜血
粪便标本中EHEC O157∶H7菌株基因检测阳性	粪便阳性
粪便标本中O104∶H4菌株基因检测阳性	粪便阳性
粪便深黄色	粪便深黄色
粪便溢流	粪便溢流
粪便潜血试验阳性	粪便阳性,便潜血
粪便病原菌培养阳性	粪便阳性
粪便轮状病毒抗体检测阳性	轮状病毒阳性,轮状病毒检测阳性
粪便量少	粪便量少
粪便难辨梭状芽孢杆菌毒素A测定阳性	粪便阳性
粪色变浅	粪色变浅
精囊硬结	精囊硬结
精液量减少	精液量减少
精神不振	倦怠,精神不振
精神不集中	精神不集中
精神刺激时不自主运动加重	精神加重,不自主运动
精神发育迟滞	发育迟滞,精神发育迟滞,发育障碍,精神迟滞
精神变化	精神变化
精神变态	精神变态
精神失常	精神失常
精神差	精神差,精神不振,精神不佳
精神异常	精神异常
精神抑郁	抑郁,精神抑郁
精神改变	精神改变
精神淡漠	精神淡漠,情感障碍,淡漠
精神病	精神病
精神症状	精神症状
精神萎靡	精神萎靡
精神行为异常	精神行为异常
精神行为改变	精神行为改变
精神运动障碍	运动障碍,运动异常,精神运动障碍
精神迟钝	精神迟钝
精神错乱	精神错乱
精神障碍	精神障碍
精索淋巴结曲张	精索淋巴结曲张
精索结节伴压痛	精索压痛,精索结节
精索附近无痛性肿块	精索肿块
精索静脉曲张	精索静脉曲张
糊状便	糊状便
糖代谢紊乱	代谢紊乱
糖化血红蛋白≥6.5%	糖化血红蛋白增高
糖化血红蛋白增高	糖化血红蛋白增高
糖尿病症状	糖尿病症状
糖尿病症状加重	糖尿病症状加重,糖尿病症状
糖尿病眼底改变	眼底改变,糖尿病
糖耐量异常	糖耐量异常
系统性妄想	妄想
系统性红斑狼疮	系统性红斑狼疮
紧张性头痛	紧张性头痛
紫癜	紫癜
紫红色丘疹	丘疹,皮疹
紫红色丘疹无瘙痒	皮疹,丘疹
紫绀	紫绀,发绀
红斑	红斑
红斑样皮疹	皮疹
红细胞乙酰胆碱酯酶（AchE）活力降低	红细胞减少
红细胞减少	红细胞减少
红细胞压积降低	红细胞减少
红细胞增多症	红细胞增多症
红细胞抗体释放试验阳性	红细胞阳性
红细胞比容大于0.65	红细胞比容大于0.65
红细胞沉降率增快	红细胞沉降率增快
红细胞渗透脆性增加	红细胞增多,脆性增加
红色斑丘疹	斑丘疹,丘疹
红色点状丘疹	丘疹,皮疹
红色皮疹	皮疹
红色细小密集斑丘疹	斑丘疹,丘疹
红葡萄酒样尿	尿红葡萄酒样
纤维蛋白原降低	纤维蛋白原降低
纳呆	纳呆
纳差	纳差
纵膈淋巴结肿大	淋巴结肿大
纵隔充气造影可见甲状腺肿瘤	甲状腺肿瘤
纵隔内积气	纵隔内积气
纵隔内积脓	纵隔内积脓
纵隔增宽	纵隔增宽
纵隔扑动	纵隔扑动
纵隔气肿	纵隔气肿
纵隔皮下气肿	纵隔气肿,皮下气肿
细小生活动作均感困难	动作细小,动作困难
细湿罗音	细湿罗音
细网格状皮肤红肿	皮肤肿胀,皮肤红肿
细胞学检查发现癌细胞	有癌细胞
终末期肾病	肾病
终末血尿	血尿
经前期点滴出血	出血
经期不规则	经期不规则
经期延长	月经异常,经期延长
经期持续时间长	经期长
经期腹痛	腹痛,经期腹痛
经期规则	经期规则
经量不定	月经异常,经量不定
经量减少	经量减少,月经异常
经量增多	月经异常,经量增多
经量增多＞80ml	经量增多,月经异常
经量过多	月经过多,经量过多,月经异常
经量过少	月经异常,经量过少,月经过少
经间期出血	出血
经间期阴道出血	阴道出血
结合胆红素升高	结合胆红素升高
结核全身中毒症状	症状结核,全身中毒
结核全身症状	全身症状
结核局部症状	局部症状
结核病	结核病
结核菌素试验强阳性	结核菌素试验强阳性
结肠充气试验阳性（Rovsing征）阳性	结肠充气试验阳性
结肠扩张充气	结肠扩张
结膜下出血	眼结膜充血,结膜出血
结膜充血	结膜充血,眼结膜充血
结膜充血水肿	结膜水肿,眼结膜充血,结膜充血
结膜出血	眼结膜充血,结膜出血
结膜干燥斑	结膜斑,结膜干燥
结膜水肿	结膜水肿
结膜滤泡	结膜滤泡
结膜灼伤	结膜灼伤
结膜炎	结膜炎
结膜瘢痕	结膜瘢痕
结膜肉芽肿	肉芽肿性炎症,肉芽肿
结膜苍白	结膜苍白,贫血
结节性硬化症	结节性硬化症
结节性红斑	红斑
结节或斑块可自行消退	症状自行消退
结节红斑样皮肤结节	皮肤结节,皮肤红斑样
给予糖皮质激素后血压下降	低血压,血压降低,血压下降
给予葡萄糖后症状缓解	症状缓解
绝望	绝望
绝经后阴道不规则出血	阴道出血
绝经后阴道流血	阴道流血,阴道出血
继发性ST-T改变	ST-T改变
继发性宫缩乏力	宫缩乏力,子宫收缩异常
继发性痛经	继发性痛经
继发细菌感染症状	感染
绿色瘤	绿色瘤
缄默	缄默
缓慢进行性痉挛性双下肢无力	双下肢缓慢,双下肢无力,无力
缺铁症	缺铁症
网织红细胞增多	网织红细胞增多
羊水增多	羊水增多
羊水流出极少	羊水流出,羊水过少
羊水过少	羊水过少
耐力下降	耐力下降
耳下部疼痛	耳痛,耳下部,耳疼痛
耳内出血	耳内出血
耳内气过水声	气过水声,耳内气过水声
耳刺痛	耳痛,耳刺痛
耳前淋巴结肿大	淋巴结肿大
耳后乳突红肿热痛	乳突压痛,耳后疼痛
耳后沟压痛	耳后沟压痛
耳后沟红肿	耳后沟红肿
耳后淋巴结肿大	耳后肿大,淋巴结肿大,耳后淋巴结肿大
耳后疼痛	耳后疼痛
耳周灼痛	耳痛,耳周灼痛
耳堵塞感	耳堵塞感
耳廓不对称	耳廓不对称
耳廓前面上方局限性隆起	耳廓隆起
耳廓感觉减退	耳廓感觉减退,感觉减退,感觉障碍,耳廓减退
耳廓波动感	耳廓波动感
耳廓灼热	耳廓灼热
耳廓灼热感	耳廓灼热感
耳廓痒感	耳廓痒感
耳廓破溃出脓	耳廓破溃,耳廓出脓
耳廓红肿	耳部肿胀,耳廓红肿
耳廓肿痛	耳廓肿痛,耳部肿胀,耳痛
耳廓肿胀	耳部肿胀,耳廓肿胀
耳廓胀感	耳廓胀感
耳廓脓肿波动感	脓肿,耳廓波动感
耳廓触痛	耳廓触痛,耳痛
耳廓隆起增大	耳廓增大,耳廓隆起
耳根部疼痛	耳根部疼痛
耳流脓	耳流脓
耳甲腔囊性隆起	耳甲腔隆起
耳疼痛	耳疼痛,耳痛
耳痒	耳痒
耳痛	耳痛
耳痛放射至同侧头部	头部放射,耳痛
耳痛放射至牙齿	耳痛,牙齿放射
耳聋	耳聋
耳胀满感	耳胀满感
耳胀痛	耳痛,耳胀痛
耳道流脓液	耳道流脓液
耳道溢液	耳道溢液,溢液
耳部刺痛	耳部刺痛,耳痛
耳部搏动性跳痛	耳部跳痛
耳部放射痛	耳部放射痛,耳痛
耳部流脓	耳部流脓
耳部疱疹	耳部疱疹,疱疹
耳部胀满感	耳部胀满感
耳闭塞感	耳闭塞
耳闷	耳闷
耳闷胀感	耳闷胀感
耳鸣	耳鸣
耸肩无力	无力,耸肩无力
耻骨上区压痛	耻骨疼痛,耻骨上区压痛
耻骨上区腹痛	耻骨上区腹痛,腹痛
耻骨上区钝痛	耻骨上区钝痛
耻骨上压痛	耻骨疼痛
耻骨上疼痛	耻骨疼痛
耻骨上膀胱区压痛	膀胱区压痛,耻骨疼痛
耻骨联合上方触及胎儿下颏	耻骨联合触及,胎儿触及
耻骨联合上方触及胎儿枕骨隆突	胎儿触及,耻骨联合触及
耻骨联合上方触及胎头顶部	耻骨联合触及,头顶部触及
耻骨联合上方触及胎臀	胎臀触及,耻骨联合触及
耻骨联合下方触及胎臀	耻骨联合触及,胎臀触及
耻骨联合分离	耻骨联合分离
聋哑	聋哑
肉眼血尿	肉眼血尿,血尿
肉芽肿	肉芽肿性炎症,肉芽肿
肉芽肿性全葡萄膜炎	葡萄膜炎
肉芽肿性炎症	肉芽肿性炎症
肉芽肿改变	肉芽肿,肉芽肿性炎症
肋脊角压痛	肋脊角压痛,肋脊角叩痛
肋脊角叩痛	肋脊角叩痛
肋软骨局部压痛	肋软骨压痛
肋软骨局部肿大	肋软骨肿大
肋软骨局部隆起	肋软骨隆起
肋软骨肿大处疼痛	肋软骨疼痛,肋软骨肿大
肋间疱疹	疱疹,肋间疱疹
肋间疼痛	肋间疼痛,胸痛,肋间痛
肋间皮肤区感觉过敏	肋间过敏,皮肤区过敏,感觉障碍,感觉过敏
肋间隙凹陷	肋间隙凹陷
肋间隙变窄	肋间隙变窄
肋间隙增宽	肋间隙增宽
肋间隙饱满	肋间隙饱满
肋骨缘压痛	肋骨缘压痛
肋骨髓腔增宽	肋骨髓腔增宽
肌力下降	肌力减弱,肌力下降
肌力减弱	肌力减弱
肌力减弱不显著	肌力减弱不显著
肌力减退	肌力减退,肌力减弱
肌力异常	肌力异常
肌力降低	肌力降低,肌力减弱
肌张力下降	肌张力减低,肌张力下降
肌张力低	肌张力低,肌张力减低
肌张力减低	肌张力减低
肌张力减退	肌张力减退,肌张力减低
肌张力增强	肌张力增高,肌张力增强
肌张力增高	肌张力增加,肌张力增高
肌张力异常	肌张力异常,肌张力障碍
肌张力降低	肌张力减低,肌张力降低
肌张力障碍	肌张力障碍
肌张力高	肌张力高
肌强直	肌肉强直,肌强直
肌无力	四肢无力,肌无力
肌无力晨轻暮重	晨轻暮重,四肢无力,肌无力
肌束震颤	肌束颤动,肌束震颤
肌束颤动	肌束颤动
肌炎	肌炎
肌病面容	肌病
肌痉挛	肌痉挛,痉挛
肌痛	肌痛
肌紧张	肌紧张
肌紧张及反跳痛	痛,肌紧张
肌紧张性收缩	肌紧张
肌肉假性肥大	肌肉肥大
肌肉僵硬	肌肉僵硬
肌肉关节痛	关节痛,肌肉关节痛
肌肉关节酸痛	肌痛,肌肉酸痛,肌肉关节酸痛,关节酸痛,关节痛
肌肉出血	肌肉出血
肌肉压痛	肌痛,肌肉压痛
肌肉压痛不显著	肌肉压痛不显著
肌肉发紧	肌肉发紧
肌肉在主动屈曲时出现疼痛	肌痛,肌肉疼痛,肌肉屈曲,肌肉痛,肌肉出现
肌肉抽搐	肌肉抽搐
肌肉挛缩	肌肉挛缩
肌肉无力	肌肉无力,无力,四肢无力
肌肉松弛	肌肉松弛
肌肉牵扯痛	肌肉牵扯痛
肌肉用力收缩后不能正常松开	肌收缩,肌肉收缩,肌肉不能
肌肉疼痛	肌肉疼痛,肌痛,肌肉痛
肌肉痉挛	痉挛,肌肉痉挛
肌肉痛	肌肉疼痛,肌痛,肌肉痛
肌肉痛性痉挛	痉挛,肌肉痉挛
肌肉萎缩	肌萎缩,肌肉萎缩
肌肉血肿	血肿
肌肉跳动感	肌肉跳动感
肌肉运动不协调	运动异常,肌肉不协调,肌肉运动不协调
肌肉连续收缩后无力	肌收缩,肌肉收缩
肌肉酸痛	肌痛,肌肉酸痛
肌肉震颤	肌肉震颤
肌肉麻木	肌肉麻木,肌肉麻痹
肌腱反射降低	肌腱反射降低
肌腱挛缩	肌腱挛缩
肌萎缩	肌萎缩
肌萎缩起病	肌萎缩
肌营养不良	肌营养不良
肌软弱无力	软弱无力
肌酐清除率下降	肌酐清除率下降
肌酸激酶同工酶（CK-MB）升高	肌酸激酶升高,同工酶（ck-mb）升高
肌酸激酶显著升高	肌酸激酶升高
肌钙蛋白T升高	肌钙蛋白增高,心肌肌钙蛋白T增高
肌钙蛋白增高	心肌肌钙蛋白T增高,肌钙蛋白增高
肌钙蛋白阳性	肌钙蛋白阳性
肌阵挛	肌阵挛
肌阵挛发作	肌阵挛
肌阵挛性痉挛发作	痉挛
肌阵挛性癫痫发作	癫痫发作,癫痫
肌颤	肌颤
肌麻痹	肌麻痹
肘关节不能伸直	肘关节不能伸直
肘关节伸直痛	肘关节伸直,肘关节疼痛,肘关节痛
肘关节关节囊增厚	肘关节关节囊增厚,肘关节增厚
肘关节关节囊挛缩	肘关节挛缩,肘关节关节囊挛缩
肘关节关节边缘骨赘	骨赘
肘关节功能障碍	肘关节功能障碍
肘关节外侧痛	肘关节痛,肘关节疼痛
肘关节屈伸受限	肘关节受限
肘关节屈曲	肘关节屈曲
肘关节屈曲不能伸直	肘关节不能伸直,肘关节屈曲
肘关节屈曲痛	肘关节疼痛,肘关节屈曲,肘关节痛
肘关节强直	肘关节强直
肘关节活动范围受限	肘受限,关节活动受限
肘关节深屈度减小	肘关节减小
肘关节滑膜增厚	肘关节增厚
肘关节畸形	肘关节畸形
肘关节疼痛	肘关节疼痛,关节痛
肘关节疼痛性弹响	肘关节弹响
肘关节绞锁	肘关节绞锁
肘关节肿痛	肘关节肿痛
肘前方可扪到骨折断断	骨折
肘外翻	肘外翻
肘部压痛明显	肘部压痛,肘部明显
肘部屈曲	肘部屈曲
肘部屈曲挛缩	肘部屈曲,肘部挛缩
肘部疼痛肿胀	肘部疼痛,肘部肿胀,肘部痛
肘部皮下瘀斑	肘部瘀斑,皮下瘀斑,肘部皮下瘀斑
肛周夜间瘙痒	肛周瘙痒
肛周有剧痛	肛门痛
肛周痛	肛周痛,肛门痛
肛周瘘管	肛周瘘管
肛周瘙痒	肛周瘙痒
肛周皮下血肿	血肿
肛周皮肤湿疹	湿疹
肛周窦道形成	窦道形成,肛周窦道形成,肛周形成
肛周脓肿	肛周肿物,肛周脓肿
肛门下坠感	肛门下坠感,肛门坠胀
肛门不适	肛门不适
肛门与脱出肠管之间有环状深沟	肠管脱出,肛门脱出,肛门深沟,肠管环状,肠管深沟,肛门环状
肛门出血	肛门出血
肛门反射减弱	肛门反射减弱
肛门反射消失	肛门反射消失
肛门坠胀	肛门坠胀
肛门坠胀感	肛门坠胀感,肛门坠胀
肛门处病变处穿刺抽出脓液	穿刺病变,脓液,肛门病变
肛门失禁	肛门失禁
肛门常有粪便及气体排出	粪便排出,肛门排出
肛门括约肌功能障碍	括约肌功能障碍,肛门括约肌功能障碍,肛门功能障碍
肛门括约肌张力降低	张力降低
肛门括约肌挛缩痛	括约肌挛缩,括约肌痛,肛门挛缩
肛门括约肌松弛	肛门松弛,肛门括约肌松弛,括约肌松弛
肛门括约肌皱褶减少	括约肌减少,括约肌降低,肛门皱褶,括约肌皱褶
肛门括约肌随意收缩功能丧失	括约肌功能丧失,肛门收缩,括约肌收缩
肛门指诊发现肛门口扩大	指诊扩大,肛门口扩大,肛门扩大
肛门指诊嘱病人用力收缩肛门括约肌仅略有收缩感觉	感觉收缩,指诊收缩,括约肌收缩,肛门收缩
肛门指诊感到肛门括约肌收缩无力	指诊收缩无力,括约肌收缩无力,肛门收缩无力
肛门指诊感觉到直肠痉挛	肠痉挛
肛门指诊有直肠壶腹部空虚感	肛门空虚感,指诊空虚感
肛门指诊直肠内充满黏液无正常空虚感	直肠空虚感,指诊空虚感,肛门充满,直肠黏液,肛门黏液,指诊黏液,直肠充满,指诊充满,肛门空虚感
肛门检查发现病变处有波动感	肛门病变,肛门波动感
肛门检查发现皮垂	肛门皮垂
肛门检查发现肛周暗紫色长条圆形肿物	肛周肿物,肛门圆形,肛门暗紫色,肛周圆形,肛周暗紫色,肛门肿物
肛门检查发现肛周肿物压痛明显	肛门明显,肛周压痛,肛门痛,肛周明显,肛门肿物,肛周肿物
肛门检查发现肛周肿物表面皮肤水肿	肛门水肿,皮肤水肿,肛门肿物,肛周肿物,表面水肿,皮肤肿胀,表面肿物
肛门检查发现肛周肿物质硬	肛门肿物,肛周肿物,肛门质硬,肛周质硬
肛门检查发现脓肿	脓肿
肛门检查可发现外痔	外痔
肛门检查急性肛裂表现	肛裂,肛门表现
肛门检查慢性肛裂表现	肛门表现,肛裂
肛门检查手指向前方可触及向阴道凸出的直肠呈盲袋	阴道触及,手指触及,直肠触及,肛门触及,阴道凸出,直肠凸出,手指凸出,肛门凸出
肛门检查时嘱病人下蹲后用力屏气直肠脱出	屏气脱出,肛门脱出,下蹲脱出,直肠脱出
肛门检查时指诊内口处有压痛	指诊压痛,肛门痛,内口压痛
肛门检查时指诊可扪及条索样瘘管	肛门扪及,肛门条索样,指诊扪及,指诊条索样,瘘管
肛门检查时指诊可扪及硬结样内口	内口硬结样,肛门硬结样,内口扪及,肛门扪及,指诊硬结样,指诊扪及
肛门检查病变处明显红肿	肛门红肿,肛门明显,肛门病变
肛门检查病变处有压痛	肛门痛,肛门病变
肛门检查病变处有硬结	肛门病变,肛门硬结
肛门溃疡	肛门溃疡
肛门潮湿不洁	肛门潮湿,肛门不洁
肛门疼痛	肛门痛,肛门疼痛
肛门痉挛	肛门痉挛
肛门痛	肛门痛,肛门疼痛
肛门瘘外口流出少量脓血分泌物	脓血,肛门瘘流出,分泌物流出,外口流出
肛门瘘外口流出黏液性分泌物	肛门瘘流出,分泌物流出,外口流出
肛门瘙痒	肛门瘙痒
肛门部潮湿	肛门部潮湿
肛门部瘙痒	肛门部瘙痒
肝内胆管扩张	肝内胆管扩张,胆管扩张
肝功能异常	肝功能异常
肝区不适	肝区不适
肝区压痛	肝区压痛,肝压痛
肝区叩击痛	肝区叩击痛,肝压痛
肝区叩痛	肝区叩痛,肝压痛
肝区疼痛	肝区疼痛,肝区痛,腹痛,肝痛
肝区痛	肝区痛,肝痛,腹痛,肝区疼痛
肝区血管杂音	血管杂音,肝区血管杂音
肝区隐痛	肝区隐痛,肝痛
肝压痛	肝压痛
肝增大	肝增大
肝大	肝大
肝大伴压痛	肝大
肝性肺病感染	感染,肺病
肝性脑病	肝性脑病
肝损害与甲亢轻重无关	甲亢
肝掌	肝掌
肝浊音界扩大	肝浊音界扩大
肝浊音界消失	肝浊音界消失
肝浊音界缩小	肝浊音界缩小
肝炎	肝炎
肝炎病毒检测阳性	肝炎病毒
肝病面容	肝病面容
肝硬化	肝硬化
肝硬化表现	肝硬化
肝硬变	肝硬变
肝穿刺活检见肝细胞内有棕褐色色素颗粒沉着	穿刺褐色
肝缩小	肝缩小
肝肿大	肝肿大
肝脏占位性病变	肝脏占位性病变
肝脏增大	肝脏增大
肝脏损害	肝脏损害
肝脏明显肿大	肝脏肿大,肝脏明显
肝脏浊音界缩小	肝脏浊音界缩小,肝脏缩小,浊音界缩小
肝脏结节	肝脏结节
肝脏缩小	肝脏缩小
肝脏肿大	肝脏肿大
肝脏轻度肿大	肝脏肿大
肝脾大	肝脾大
肝脾肿大	脾肿大,脾大
肝表面多个囊性结节	表面结节,肝结节
肝轻度肿大	肝肿大
肝部触痛	肝部触痛,肝压痛
肝颈回流征阳性	肝颈回流征阳性,肝颈反流征阳性
肝颈静脉反流征阳性	肝颈反流征,肝颈静脉反流征阳性,肝颈静脉反流征
肝颈静脉回流征阳性	肝颈静脉回流征阳性
肠套叠表现	肠套叠
肠息肉	肠息肉
肠扭转	肠扭转
肠梗阻	肠梗阻
肠梗阻症状	肠梗阻
肠梗阻表现	肠梗阻
肠痉挛	肠痉挛
肠瘘	肠瘘
肠穿孔	肠穿孔
肠穿孔表现	肠穿孔
肠管咕噜声	肠管咕噜声
肠管扩张	肠管扩张
肠管狭窄	肠管狭窄
肠粘连	肠粘连
肠绞痛	肠绞痛
肠胀气	肠胀气
肠蠕动减少	肠蠕动减少
肠道出血	肠道出血
肠道大出血	肠道大出血,肠道出血
肠道病毒感染	病毒感染,肠道病毒感染
肠鸣音亢进	肠鸣音亢进
肠鸣音减少	肠鸣音减少
肠鸣音减弱	肠鸣音减弱,肠鸣音弱
肠鸣音呈气过水声	肠鸣音气过水声,气过水声
肠鸣音呈高调金属音	肠鸣音高调
肠鸣音增强	肠鸣音增强
肠鸣音气过水声	肠鸣音气过水声,气过水声
肠鸣音活跃	肠鸣音活跃
肠鸣音消失	肠鸣音消失
肠鸣音高调金属音	肠鸣音高调
股内收肌紧张	股内收肌紧张
股动脉搏动不能扪及	股动脉搏动不能扪及
股动脉搏动减弱	股动脉搏动微弱,股动脉搏动减弱
股动脉搏动延迟	股动脉搏动延迟
股动脉搏动弱甚至不能扪及	股动脉搏动微弱,股动脉搏动不能扪及
股动脉搏动微弱	股动脉搏动微弱
股动脉搏动缺如	股动脉搏动缺如
股动脉枪击音	股动脉枪击音
股后疼痛	股后疼痛,股痛
股四头肌萎缩	股四头肌萎缩
股部海绵状肿块	股部肿块,股部海绵状
股骨内髁皱襞摩擦感	皱襞摩擦感
股骨内髁皱襞摩擦音	皱襞摩擦音
肢体不适感	肢体不适感,肢体不适
肢体僵硬	肢体僵硬
肢体共济失调	共济失调,肢体共济失调
肢体冷感	肢体冷感
肢体刺痛	肢体疼痛,肢体刺痛
肢体发冷	发冷,肢体发冷,肢体冷感
肢体发凉	肢体发凉,发冷,发凉
肢体发绀	肢体发绀,发绀
肢体呈下运动神经元性瘫痪	下运动神经元性瘫痪
肢体增粗	肢体增粗
肢体增粗及变形	肢体增粗,肢体变形
肢体增长	肢体增长
肢体对称性迟缓性肌无力	四肢无力,肌无力
肢体怕冷	怕冷,肢体怕冷
肢体感觉异常	肢体感觉异常
肢体感觉缺失呈手套-袜套样分布	肢体感觉缺失,肢体手套-袜套样
肢体感觉障碍	肢体感觉障碍,肢体障碍,感觉障碍
肢体成角畸形	肢体畸形
肢体抬高试验阳性	肢体抬高试验阳性
肢体无力	四肢无力,乏力,肢体无力
肢体末端溃疡	肢体溃疡
肢体活动受限	关节屈曲,肢体活动受限
肢体浅静脉曲张	静脉曲张
肢体湿冷	肢体冷感,肢体湿冷
肢体灼痛	肢体疼痛,肢体灼痛
肢体烧灼感	肢体远端针刺感,肢体烧灼感
肢体烧灼感、针刺感	肢体远端针刺感,肢体烧灼感,肢体针刺感
肢体畸形	肢体畸形
肢体疼痛	肢体疼痛
肢体疼痛感	肢体疼痛感
肢体痉挛	痉挛,肢体痉挛
肢体瘫痪	瘫,瘫痪
肢体皮温降低	皮温降低,肢体皮温降低,肢体降低
肢体皮肤多汗	皮肤多汗,多汗
肢体皮肤感觉异常	肢体皮肤感觉异常,肢体感觉异常,皮肤感觉异常
肢体皮肤温度升高	肢体升高,肢体皮肤温度升高
肢体皮肤温度降低	肢体降低,皮肤温度降低,肢体皮肤温度降低
肢体皮肤湿疹	湿疹
肢体皮肤红色斑块状血管瘤	皮肤斑块,肢体斑块,肢体红色,血管瘤,皮肤红色
肢体皮肤色素沉着	肢体色素沉着,皮肤色素沉着,肢体皮肤色素沉着
肢体短缩	肢体短缩
肢体红肿热痛	肢体疼痛
肢体肌力下降	肌力减弱,肌力下降,肢体下降,肢体肌力下降
肢体肌张力降低	肌张力减低,肌张力降低,肢体降低,肢体肌张力降低
肢体肌肉萎缩	肢体肌肉萎缩,肢体萎缩,肌萎缩,肌肉萎缩
肢体肿块疼痛	肢体肿胀,肢体疼痛
肢体肿胀	肢体肿胀
肢体苍白	肢体苍白
肢体蚁走感	蚁走感,肢体蚁走感
肢体软瘫	软瘫
肢体运动障碍	运动障碍,肢体运动障碍,运动异常
肢体近端肌肉无力	肌肉无力,无力,四肢无力
肢体远端对称性感觉障碍	肢体感觉障碍,肢体障碍,感觉障碍
肢体远端对称性浅感觉减退	肢体减退,浅感觉减退
肢体远端对称性浅感觉缺失	肢体感觉缺失
肢体远端对称性深感觉减退	肢体减退,深感觉减退
肢体远端对称性深感觉缺失	肢体深,肢体感觉缺失
肢体远端对称性肌无力	肌无力,四肢无力
肢体远端对称性运动障碍	运动障碍,肢体运动障碍,运动异常
肢体远端感觉异常	肢体感觉异常
肢体远端手套-袜套样分布的对称性感觉障碍	肢体感觉障碍,肢体障碍,感觉障碍,感觉手套-袜套样,肢体手套-袜套样
肢体远端烧灼感	肢体烧灼感,肢体远端针刺感
肢体远端肌束颤动	肌束颤动,肢体颤动
肢体远端肌肉无力	肌肉无力,四肢无力,无力
肢体远端肌肉萎缩	肌萎缩,肢体肌肉萎缩,肢体萎缩,肌肉萎缩
肢体远端肌萎缩	肌萎缩
肢体远端蚁走感	肢体蚁走感,蚁走感
肢体远端蠕动明显	肢体蠕动,肢体明显
肢体远端触痛	肢体疼痛
肢体远端针刺感	肢体针刺感
肢体远端麻木	肢体麻木
肢体酸胀	肢体酸胀
肢体针刺感	肢体针刺感
肢体震颤	肢体震颤
肢体静息痛	肢体疼痛,肢体静息痛
肢体静脉性溃疡	肢体静脉性溃疡,静脉性溃疡
肢体麻木	肢体麻木
肢体麻木感	肢体麻木,肢体麻木感
肢体麻木无力	肢体麻木,肢体麻木无力
肢端刺痛	肢端刺痛
肢端坏疽	肢端坏疽,坏疽
肢端感觉丧失呈袜套样分布	肢端袜套样,肢端丧失,感觉袜套样,感觉丧失,感觉障碍
肢端感觉过敏	肢端过敏,肢端感觉过敏,感觉障碍,感觉过敏
肢端湿冷	肢端湿冷
肢端溃疡	肢端溃疡
肢端疼痛	肢端疼痛
肢端皮温降低	肢端皮温降低,肢端降低,皮温降低
肢端皮肤潮红	皮肤红,肢端皮肤潮红,皮肤潮红,肢端潮红
肢端皮肤阵发性皮温升高	皮肤升高,肢端升高,皮温升高
肢端肥大	肢端肥大
肢端肿胀	肢端肿胀
肢端蚁行感	肢端蚁行感
肢端袜套样分布的感觉丧失	肢端袜套样,肢端丧失,感觉袜套样,感觉丧失,感觉障碍
肢端麻木	肢体麻木,肢端麻木
肤色偏黄	肤色偏黄
肤色变黑	肤色变黑
肥胖	肥胖
肥胖性生殖无能综合征	肥胖性生殖无能综合征
肥达氏反应阳性	肥达氏反应阳性
肩关节外展疼痛加重	关节痛,肩关节疼痛,肩关节痛,肩关节加重,肩痛,肩关节外展
肩关节外旋疼痛加重	肩关节痛,肩关节加重,肩痛,肩关节外旋,关节痛,肩关节疼痛
肩关节活动受限	肩关节活动受限
肩关节活动障碍	肩关节活动障碍,关节活动障碍,肩障碍,关节功能障碍
肩关节疼痛	关节痛,肩关节疼痛,肩痛,关节疼痛
肩带肌萎缩	肌萎缩
肩疼痛	肩痛,肩疼痛
肩背部疼痛	背部疼痛,肩背部疼痛,肩痛,背痛
肩胛区疼痛	肩胛区疼痛,肩胛疼痛
肩胛带肌僵硬	肌僵硬,肩胛带僵硬,肩胛带肌僵硬
肩胛带肌肉萎缩	肌萎缩,肩胛带萎缩,肌肉萎缩,肩胛带肌肉萎缩
肩部压痛	肩痛,肩部压痛
肩部外侧压痛	肩部压痛,肩痛
肩部外侧疼痛	肩痛,肩部疼痛
肩部活动障碍	肩部障碍,肩部活动障碍,活动障碍
肩部疼痛	肩痛,肩部疼痛
肩颈部肌肉僵硬感	僵硬感
肱动脉搏动不能扪及	肱动脉搏动不能扪及
肱动脉搏动减弱	肱动脉搏动减弱
肱动脉搏动微弱	肱动脉搏动微弱
肱动脉搏动消失	肱动脉搏动消失
肱动脉血压高于腘动脉	血压高
肱骨外上髁与桡骨头之间压痛	头部压痛,肱骨压痛,桡骨压痛
肺上叶渗出影	肺渗出影
肺下界降低	肺下界降低
肺不张	肺不张
肺不张表现	肺不张表现,肺不张
肺内空洞形成	肺浸润
肺内薄壁空洞	肺浸润,肺内薄壁空洞
肺动脉主干可有窄后扩张	肺动脉扩张
肺动脉内有低密度充盈缺损	肺动脉充盈缺损,肺动脉栓塞
肺动脉区收缩期杂音	收缩期杂音,心尖区收缩期杂音,心脏杂音
肺动脉段膨隆	肺动脉段膨隆
肺动脉狭窄	肺动脉狭窄
肺动脉瓣关闭不全	肺动脉瓣关闭不全
肺动脉瓣区可闻及杂音	肺动脉瓣区杂音
肺动脉瓣区第二心音亢进	肺动脉瓣区第二音亢进,P2亢进,肺动脉瓣区第二心音亢进
肺动脉瓣区第二心音分裂	第二心音分裂,肺动脉瓣区第二心音分裂
肺动脉瓣狭窄	肺动脉瓣狭窄
肺动脉第二心音亢进	肺动脉第二心音亢进,P2亢进
肺动脉第二心音减弱	第二心音弱,肺动脉第二心音减弱,肺动脉减弱
肺动脉第二心音分裂	第二心音分裂,肺动脉第二心音分裂
肺动脉第二心音增强	肺动脉增强,肺动脉第二心音增强
肺动脉血栓	血栓
肺动脉高压	肺动脉高压,肺动脉压力升高
肺型P波	肺型P波
肺实变	肺实变
肺底部湿啰音	湿啰音,肺部啰音,感染
肺底闻及湿啰音	湿啰音,肺部啰音,感染
肺心病	肺心病
肺气肿	肺气肿
肺水肿	肺水肿,肺气肿
肺活量减少	肺活量减少
肺浸润或空洞形成	肺浸润,肺空洞
肺炎	肺炎
肺纤维化	肺纤维化
肺纹理增粗	肺纹理增粗
肺纹理紊乱	肺纹理紊乱,肺纹理增强
肺组织呈毛玻璃样改变	肺部病变
肺结节影	肺结节影,肺部结节
肺脓肿	肺脓肿,肺气肿
肺血减少	肺血减少
肺血流量减少	肺血减少
肺通气功能障碍	通气功能障碍,肺通气功能障碍
肺通气量下降	肺通气量下降
肺部X线可见囊肿随深呼吸或体位改变而变形	体位改变,深呼吸
肺部云雾状浸润影	肺部浸润影
肺部可闻及干性啰音	干性啰音
肺部可闻及湿性啰音	湿啰音,肺部啰音
肺部啰音	肺部啰音
肺部干湿啰音	肺部湿啰音,感染,湿啰音,肺部啰音
肺部感染	肺部感染,两肺感染灶
肺部感染表现	两肺感染灶,肺部感染,肺部感染表现
肺部斑片状阴影	肺部斑片状阴影
肺部活检病理示隐球菌感染	肺部感染,两肺感染灶
肺部湿啰音	湿啰音,肺部啰音,肺部湿啰音,感染
肺部湿罗音	肺部啰音,湿罗音,肺部湿罗音,湿啰音
肺部炎症	肺部炎症
肺部空洞	肺部空洞
肺部粟粒状阴影	肺部阴影
肺部细湿啰音	感染,肺部细,湿啰音,肺部啰音,肺部湿啰音
肺部结节	肺部结节
肺部肿块影	肺部肿物
肺部边缘清晰、光滑、密度较高的球形阴影，内有钙化点	肺部阴影
肺部闻及干性啰音	干性啰音
肺部闻及水泡音	水泡音
肺部闻及湿啰音	湿啰音,肺部啰音,肺部湿啰音,感染
肺野内呈现圆形或类圆形的致密阴影	肺野阴影
肺门淋巴结肿大	淋巴结肿大,肺门淋巴结肿大
肾上腺体积增大	肾上腺体积增大
肾上腺皮质功能减退症状	肾上腺皮质功能减退症状
肾上腺肿块	肾上腺肿块
肾上腺肿瘤	肾上腺肿瘤
肾功能不全	肾功能不全
肾功能减退	肾功能减退
肾功能异常	肾功能异常,肾功能改变
肾功能衰竭	肾功能衰竭
肾动脉狭窄	肾动脉狭窄
肾区压痛	肾区疼痛,肾区压痛
肾区叩击痛	肾区叩击痛,肾区疼痛
肾区叩痛	肾区疼痛,肾区叩痛
肾区疼痛	肾区疼痛
肾区肿块	肾区肿块
肾区触及表面凹凸不平的肾脏	表面凹凸不平,肾脏触及,肾区凹凸不平,肾脏凹凸不平,表面触及,肾区触及
肾区造影剂外溢	造影剂外溢,肾区造影剂外溢
肾发育异常	肾发育异常,肾异常,发育异常
肾小球滤过率下降	肾小球滤过率下降
肾小球系膜增生	肾小球系膜增生
肾小球结节性硬化（K-W结节）	结节性硬化
肾小球肾炎	肾炎,肾小球肾炎
肾小管功能受损	肾小管功能受损
肾小管酸中毒	肾小管酸中毒
肾畸形	肾畸形
肾盂积水	肾盂积水
肾盂肾炎	肾盂肾炎
肾结石	肾结石
肾绞痛	肾绞痛
肾肿大	肾肿大
肾脏临床表现较轻	肾脏临床表现较轻,临床表现较轻,肾脏较轻
肾脏体积缩小	肾缩小,肾脏体积缩小
肾脏系膜细胞增生	肾脏系膜细胞增生,系膜细胞增生
肾脏肿块	肾脏肿块
肾萎缩	肾萎缩
肾衰竭	肾衰竭
肿块局部有血管杂音	血管肿块,血管杂音
肿块局部皮肤红热	皮肤红热,皮肤肿胀
肿块皮肤破溃	皮肤肿胀,皮肤破溃
肿块还纳后在腹白线区扪及缺损的空隙	腹缺损,白线空隙,腹包块,腹肿块,白线肿块,腹空隙,白线扪及,腹扪及,白线缺损
肿块透光试验阳性	肿块透光试验阳性
肿块随吞咽运动上下	运动肿块,吞咽肿块
肿块随年龄增长而增大	年龄增大,年龄增长
肿大淋巴结固定	淋巴结肿大,淋巴结固定
肿大淋巴结触痛	淋巴结触痛,淋巴结疼痛,淋巴结肿大
肿大淋巴结质硬	淋巴结肿大,淋巴结质硬
肿大甲状腺随吞咽上下活动	甲状腺肿大,吞咽肿大,活动肿大
肿物叩诊鼓音	叩诊鼓音,叩诊肿物
肿物触诊柔韧感	触诊肿物,触诊柔韧感
肿瘤平面以下同侧肢体深感觉消失	肢体消失,深感觉消失,肿瘤
肿瘤平面以下同侧肢体瘫痪	肿瘤,瘫,瘫痪
肿瘤平面以下对侧痛温觉缺失	痛温觉缺失,肿瘤
肿瘤转移症状	肿瘤转移症状
肿胀处疼痛	肿胀处疼痛
胁腹部疼痛	胁腹部疼痛
胃区胀满	胃区胀满
胃反流	胃反流
胃息肉	胃息肉
胃扭转	胃扭转
胃排空延迟（胃轻瘫）	胃轻瘫,胃延迟
胃灼热	胃灼热
胃痛	胃痛
胃粘膜出血	出血
胃纳不佳	胃纳,胃纳不佳
胃纳减退	胃纳不佳,胃纳减退,胃纳
胃肠功能紊乱	胃肠功能紊乱
胃肠胀气	胃气胀,胃肠胀气
胃肠蠕动亢进	胃肠蠕动亢进
胃肠蠕动差	胃肠蠕动差
胃肠道出血	胃肠道出血
胃肠道病症	胃肠道病症
胃胀满	胃胀满
胃蠕动波	胃蠕动波
胃轻瘫	胃轻瘫
胃酸减少	胃酸过少,胃酸减少
胃酸过少	胃酸过少
胃镜可见食管与胃交界处或食管远端、贲门黏膜的纵行撕裂	食管撕裂,贲门撕裂
胃镜检查可见胃腔内大量食物潴留	食物潴留
胃镜检查可见贲门狭窄	贲门狭窄
胃镜检查可见食管扩张扭曲变形	食管扩张
胃镜检查示浅表性胃炎	浅表性胃炎
胃镜活检有干酪样肉芽肿	肉芽肿,肉芽肿性炎症
胃镜示反流性食管炎	反流性食管炎
胃镜见胃粘膜糜烂出血	出血
胃食管反流病症状	胃食管反流病,胃食管反流病症状
胃黏膜糜烂	胃黏膜糜烂
胆囊破裂	胆囊破裂
胆囊肿大	胆囊肿大
胆囊触痛	胆囊触痛
胆总管囊状扩张	胆总管扩张
胆总管扩张	胆总管扩张
胆汁性腹膜炎	腹膜炎
胆汁淤积	胆汁淤积
胆汁酸增高	胆汁酸增高
胆碱酯酶抑制剂治疗有效	胆碱酯酶治疗有效,胆碱酯酶抑制剂治疗有效,抑制剂治疗有效
胆管扩张	胆管扩张
胆绞痛	胆绞痛
胆道出血	胆道出血
胆道大出血	胆道出血,胆道大出血
胆道疾病治疗后心脏症状消失	症状消失,胆道疾病
背痛	背痛
背部两侧背脊角血管杂音	血管杂音,背部杂音,背脊角杂音
背部中线囊性肿物	背部肿物
背部中线皮肤瘢痕	皮肤瘢痕
背部放射痛	背部放射痛,背痛
背部疼痛	背痛,背部疼痛
背部闻及血管杂音	背部闻及血管杂音
胎位不清	胎方位,胎位异常,胎位不清
胎位异常	胎方位,胎位异常
胎体大	胎体大
胎便排出延迟	胎便排出延迟
胎便排出缓慢	胎便排出缓慢
胎儿位于宫腔外	胎儿位于,宫腔位于
胎儿宫内慢性缺氧	缺氧
胎儿宫内缺氧	缺氧
胎儿生长受限	胎儿生长受限
胎儿畸形	胎儿畸形
胎儿肢体不易触及	肢体不易触及,胎儿肢体不易触及,胎儿不易触及
胎儿肢体侧下腹部胎心清晰	胎心清晰,胎儿清晰,肢体清晰
胎儿肢体极易触及	胎儿极易触及,肢体极易触及,胎儿肢体极易触及
胎儿肢体靠近腹前壁	肢体靠近腹前壁,胎儿肢体靠近腹前壁,胎儿靠近腹前壁
胎儿苍白	胎儿苍白
胎先露部升高	胎先露部升高
胎先露高浮	胎方位,胎先露高浮
胎动停止	胎动异常,胎动停止
胎动减少	胎动异常,胎动减少
胎动异常活跃	胎动异常,胎动活跃
胎动消失	胎动异常,胎动消失
胎囊堵塞于宫颈内口	宫颈内口堵塞,胎囊堵塞
胎头下降停滞	胎头下降停滞
胎头不下降	胎头不下降
胎头未入盆	胎头未入盆
胎头衔接受阻	胎头衔接受阻
胎头跨耻征阳性	跨耻征,胎头阳性
胎心不规律	胎心不规律
胎心位置在近腹中线	胎心位置在近腹中线
胎心位置高	胎心位置高
胎心减慢	胎心减慢
胎心听不清	胎心听不清
胎心在脐上方	胎心在脐上方
胎心在脐下最清晰	胎心在脐下最清晰
胎心增快	胎心增快
胎心异常清晰	胎心异常清晰
胎心消失	胎心消失
胎心遥远	胎心遥远
胎死宫内	胎死宫内
胎盘功能减退	胎盘功能减退
胎盘杂音响亮	胎盘杂音响亮
胎盘母体面有凝血块	胎盘母体面有凝血块
胎盘母体面有压迹	胎盘母体面有压迹
胎盘附着处压痛明显	胎盘附着处明显,胎盘附着处压痛
胎粪排出延迟	胎粪排出延迟
胎背靠近腹前壁	胎背靠近腹前壁,胎方位
胎膜早破	胎膜早破
胎膜未破	胎膜未破
胎膜紧贴胎先露	胎膜紧贴胎先露
胚胎组织堵塞于宫颈内口	组织堵塞,宫颈内口堵塞,胚胎堵塞
胡须稀少	胡须稀少
胫前粘液性水肿	胫前粘液性水肿,胫前水肿,粘液性水肿
胫前黏液性水肿	胫前水肿
胫后动脉搏动减弱	胫后动脉搏动减弱,动脉搏动减弱
胫后动脉搏动增强	胫后动脉搏动增强,动脉搏动增强,胫后增强
胫后动脉搏动存在	胫后动脉搏动存在,动脉搏动存在,胫后存在
胫后动脉搏动消失	动脉搏动消失,胫后消失,猝死,胫后动脉搏动消失
胫骨前粘液水肿	粘液水肿
胫骨结节压痛	胫骨结节,胫骨压痛
胫骨结节周围软组织肿胀	胫骨肿胀,软组织结节,胫骨结节,软组织肿胀
胫骨结节处疼痛	结节处疼痛,胫骨结节处疼痛,胫骨疼痛
胫骨结节处肿块	结节处肿块,胫骨结节处肿块,胫骨肿块
胫骨结节隆起	胫骨结节,胫骨隆起
胫骨结节骨骺增大致密	胫骨结节
胫骨结节骨骺碎裂	胫骨结节,胫骨碎裂
胰岛素抵抗	胰岛素抵抗
胰腺肿物	胰腺肿物
胸前导联（V1～4）T波倒置	T波倒置
胸壁压痛	胸痛,胸壁压痛
胸壁局部溃疡	胸壁溃疡
胸壁局部疼痛	胸痛
胸壁局部瘘管	瘘管
胸壁局部脓肿破溃	胸壁破溃,脓肿
胸壁无痛软块	胸壁无痛软块
胸壁畸形	胸壁畸形
胸壁肌强直	肌强直,肌肉强直,胸壁肌强直
胸壁肿块	胸壁肿块
胸廓不对称	胸廓不对称
胸廓发育畸形	胸廓畸形,发育畸形,胸廓发育畸形
胸廓塌陷	胸廓塌陷
胸廓异常	胸廓异常
胸廓扁平	胸廓扁平
胸廓挤压试验阳性	胸廓阳性
胸廓活动度减低	胸廓减低,活动度减低,胸廓活动度减低
胸廓漏斗状畸形	胸廓畸形
胸廓畸形	胸廓畸形
胸廓饱满	胸廓饱满
胸椎疼痛	胸椎疼痛
胸水	胸水
胸水ADA/血清ADA比值增大	胸水
胸水C3下降	胸水
胸水C4下降	胸水
胸水CEA增高	cea升高,胸水
胸水LDH增高	胸水
胸水pH值小于7.0	胸水
胸水以淋巴细胞和单核细胞增高为主	单核细胞增多,淋巴细胞增多,胸水
胸水找到抗酸杆菌	胸水
胸水抗核抗体增高	胸水
胸水淀粉酶增高	胸水
胸水渗出液	胸水
胸水类风湿因子增高	胸水
胸水细菌培养阳性	胸水
胸水肿瘤标记物增高	胸水
胸水胆固醇增高	胸水,胆固醇增高
胸水腺苷脱氨酶（ADA）升高	胸水
胸水臭味	胸水
胸水葡萄糖低	胸水
胸片包裹性胸腔积液	胸腔积液
胸片片状影	胸片片状影,肺部片状影
胸片肺气肿表现	肺气肿
胸片肺淤血	肺瘀血
胸片肺间质病变	肺间质病变
胸痛	胸痛
胸痛半小时内缓解	胸痛
胸痛向下肢放射	肢放射,胸痛
胸痛向下颌放射	胸痛
胸痛向肩背部放射	背部放射,胸痛,肩放射
胸痛向肩部放射	胸痛
胸痛向背部放射	胸痛
胸痛向腹部放射	腹部放射,胸痛
胸痛向颈部放射	颈部放射,胸痛
胸痛持续时间大于30分钟	胸痛
胸痛持续时间较长	胸痛
胸痛放射到咽部	胸痛
胸痛放射到左肩部	胸痛
胸痛放射到颈部	胸痛,颈部放射
胸肩痛	肩痛,胸肩痛
胸背部持续性钝痛	胸背钝痛
胸背部疼痛	胸背痛,胸痛
胸背部胀痛	胸痛
胸腔积液	胸腔积液
胸腔积液呈血性	胸腔积液
胸腔积液征	胸腔积液征
胸腔积液检查发现癌细胞	有癌细胞,胸腔积液
胸腔穿刺液为脓液	胸腔积液
胸腹壁静脉曲张	胸腹壁静脉曲张,静脉曲张
胸腹部束带感	胸腹束带感
胸腺增大	胸腺增大
胸腺肿大	胸腺肿大
胸膜增厚	胸膜增厚
胸膜增厚粘连	胸膜粘连,胸膜增厚
胸膜性胸痛	胸痛
胸膜摩擦音	胸膜摩擦音
胸膜炎	胸膜炎
胸膜粘连	胸膜粘连
胸膜肥厚	胸膜肥厚,胸膜增厚
胸部X 线可呈现新的或进展性肺泡浸润甚至实变	肺泡浸润
胸部X线示心脏进行性增大	心脏增大
胸部X线示肺动脉段凹陷	肺动脉段凹陷
胸部X线示肺动脉段平直	肺动脉段平直
胸部不适	胸部不适
胸部刺痛	胸痛,胸部刺痛
胸部压榨感	胸部压榨感
胸部叩诊呈浊音	胸部叩诊呈浊音,胸部叩诊浊音
胸部叩诊呈鼓音	胸部叩诊鼓音
胸部叩诊鼓音	胸部叩诊鼓音
胸部含气囊肿	气囊肿
胸部外伤	外伤,胸部外伤
胸部搏动性肿块	胸部肿物
胸部浅表静脉怒张	静脉怒张
胸部痛温觉丧失	胸部痛温觉丧失,痛温觉丧失,胸部丧失
胸部紧缩感	胸部紧缩感
胸部红斑	胸部红斑
胸部钝痛	胸部钝痛,胸痛
胸部隐痛	胸部隐痛,胸痛
胸部静脉曲张	胸部静脉曲张,静脉曲张
胸部饱满	胸廓饱满,胸部饱满
胸锁乳突肌不受累	胸锁乳突肌不受累
胸锁乳突肌无力	胸锁乳突肌无力,无力
胸锁乳突肌萎缩	胸锁乳突肌萎缩
胸锁乳突肌麻痹	胸锁乳突肌麻痹
胸闷	胸闷
胸骨上窝凹陷	胸骨上窝凹陷
胸骨上闻及连续性血管杂音	心脏杂音,血管杂音,胸骨杂音
胸骨下段压痛	胸骨压痛,骨痛
胸骨下端局部压痛	骨痛,胸骨压痛
胸骨中下段压痛	胸骨压痛,骨痛
胸骨凹陷	胸骨凹陷
胸骨压痛	胸骨压痛,骨痛
胸骨右缘第2肋间收缩期喷射性杂音，向颈部传导	心脏杂音,心尖区收缩期杂音,收缩期杂音,胸骨杂音,颈部杂音
胸骨右缘第二肋间能扪及收缩期震颤	肋间扪及,收缩期震颤,胸骨震颤,胸骨扪及,肋间震颤
胸骨后不适	胸骨后不适
胸骨后压榨性疼痛	胸痛,胸骨后痛,胸骨后疼痛
胸骨后压迫感	胸骨后压迫感
胸骨后异物感	异物感,胸骨后异物感
胸骨后沉重感	胸骨后沉重感
胸骨后烧灼感	胸骨后烧灼感
胸骨后甲状腺肿	甲状腺肿大,胸骨后甲状腺肿
胸骨后疼痛	胸骨后痛,胸骨后疼痛,胸痛
胸骨后钝痛	胸骨后钝痛
胸骨后阻塞感	胸骨后阻塞感
胸骨后食物停滞	胸骨后食物停滞
胸骨左缘2-4肋间喷射样收缩期杂音	心尖区收缩期杂音,心脏杂音,胸骨肋间收缩期杂音,肋间喷射样,肋间杂音,胸骨喷射样,收缩期杂音
胸骨左缘3~4肋间新出现收缩期杂音伴震颤	肋间震颤,心尖区收缩期杂音,收缩期杂音,胸骨肋间收缩期杂音,肋间出现,胸骨震颤,肋间杂音,心脏杂音,胸骨出现
胸骨左缘3、4肋间全收缩期杂音	全收缩期杂音
胸骨左缘持续性机器样杂音	胸骨杂音,心脏杂音
胸骨左缘收缩期震颤	收缩期震颤,胸骨震颤
胸骨左缘第2、3肋间收缩期喷射性杂音	胸骨杂音,收缩期杂音,心脏杂音,心尖区收缩期杂音,肋间杂音
胸骨左缘第2肋间连续性杂音	心脏杂音,胸骨杂音
胸骨左缘第3、4 肋间可闻及双期连续性杂音	心脏杂音,肋间杂音,胸骨杂音
胸骨左缘第3、4肋间全收缩期杂音	全收缩期杂音
胸骨左缘第二肋间喷射性收缩期杂音	胸骨肋间收缩期杂音,肋间杂音,收缩期杂音,心脏杂音,心尖区收缩期杂音
胸骨左缘第二肋间收缩期吹风样杂音	心脏杂音
胸骨左缘第二肋间收缩期震颤	收缩期震颤,胸骨震颤,肋间震颤
胺臭味试验阳性	胺臭味试验阳性
胼胝	胼胝
脂溢性丘疹	丘疹,皮疹
脂溢性皮炎	脂溢性皮炎
脂肪泻	脂泻,脂肪泻
脂肪消失	脂肪消失
脂肪肝	脂肪肝
脂血症眼底改变	眼底改变,脂血症
脉压减小	脉压减小
脉压变小	脉压变小,脉压减小
脉压增大	脉压增大
脉压增宽	脉压增宽
脉压小	脉压小
脉弱	脉弱,脉搏微弱
脉律不齐	脉律不齐
脉搏不稳	脉搏不稳
脉搏减弱	脉搏减弱
脉搏加快	脉率加快,脉搏增快,脉搏加快
脉搏增快	脉搏增快,脉搏加快,脉率加快
脉搏微弱	脉搏微弱
脉搏快	脉搏快
脉搏快而弱	脉搏快而弱
脉搏快而细弱	脉搏快,脉搏微弱,脉搏细弱
脉搏有力	脉搏有力
脉搏洪大	脉搏洪大
脉搏短绌	脉搏短绌
脉搏细小	脉搏细小
脉搏细弱	脉搏细弱,脉搏微弱
脉搏细数	脉搏细数
脉搏细速	脉搏细速,脉率加快
脉搏缓慢	脉搏缓慢
脉率加快	脉率加快
脉率加速	脉率加速,脉率加快
脉率增高	脉率加快,脉率增高
脉率快	脉率快,脉率加快
脉率降低	脉率降低
脉细弱	脉搏微弱,脉细弱
脉细快	脉细快,脉率加快
脉络膜栗粒状结核结节	脉络膜结节,脉络膜结核
脉络膜视网膜炎	视网膜炎
脊柱侧凸	脊柱侧凸
脊柱侧屈	脊柱侧屈
脊柱侧弯	脊柱侧弯
脊柱侧弯受限	脊柱侧弯受限
脊柱偏离中线	脊柱偏离中线
脊柱前屈受限	脊柱前屈受限
脊柱压缩性骨折	脊柱骨折
脊柱叩击痛	脊柱痛,脊柱叩击痛
脊柱后伸受限	脊柱后伸受限
脊柱后侧凸畸形	脊柱侧凸,脊柱畸形
脊柱后凸	脊柱后凸
脊柱异常	脊柱异常
脊柱强直	脊柱强直
脊柱活动受限	脊柱活动受限
脊柱畸形	脊柱畸形
脊柱自发痛	脊柱自发痛
脊柱裂	脊柱裂
脊柱转动受限	脊柱转动受限
脊肋角叩痛	脊肋角叩痛
脊膜刺激症状	脊膜刺激
脊髓休克	休克,脊髓休克
脊髓半切综合征	脊髓半切综合征
脊髓压迫神经症状	神经症状,脊髓压迫
脊髓灰质炎病毒阳性	脊髓灰质炎
脊髓蛛网膜下隙出血	蛛网膜下隙出血
脏器疼痛	脏器疼痛
脐周围皮肤青紫及两侧肋腹皮肤灰蓝色	皮肤青紫,脐周灰蓝色,皮肤灰蓝色,脐周青紫
脐周异常搏动感	脐周搏动感,脐周异常
脐周浅表静脉曲张	静脉曲张
脐周疼痛	脐周痛
脐周痛	脐周痛
脐周皮肤瘀斑	脐周皮肤瘀斑,皮肤瘀斑,皮肤出血点,脐周瘀斑
脐带脱垂	脐带脱垂
脐疝	脐疝
脐突出	脐突
脐部半球形肿块	脐部肿块
脐部渗血	脐部渗血
脐部膨出包块	脐部膨隆
脑出血	脑出血
脑力不足	脑力不足
脑力衰退	脑力衰退
脑动脉狭窄	脑动脉狭窄,动脉狭窄
脑动脉闭塞	脑动脉闭塞
脑干缺血综合征	脑干缺血综合征
脑栓塞	脑栓塞
脑梗塞	脑梗塞
脑水肿	脑水肿
脑炎	脑炎
脑电图异常	脑电图异常
脑电图明显异常	脑电图异常,脑电图明显
脑电图有异常波形	脑电图异常波形
脑电图有特征性异常	脑电图异常
脑疝	脑疝
脑疝形成	脑疝
脑瘫	脑瘫
脑白质密度降低	脑白质密度降低
脑神经受损症状	神经受损症状,脑神经受损,脑神经受损症状
脑神经损害	脑神经受损,脑神经损害
脑神经损害体征	脑神经损害体征
脑神经损害症状	脑神经受损,脑神经损害,症状损害,脑神经损害症状
脑神经支配肌肉肌无力	脑神经支配肌肉肌无力,肌无力,四肢无力
脑神经麻痹	脑神经麻痹
脑积水	脑积水
脑组织破坏症状	脑组织破坏症状
脑缺血症状	脑缺血
脑脊液压力增高	脑脊液压力增高
脑脊液墨汁染色隐球菌阳性	脑脊液阳性
脑脊液外溢	脑脊液外溢
脑脊液浑浊	脑脊液浑浊
脑脊液淋巴细胞增高	脑脊液淋巴细胞增高,淋巴细胞增多
脑脊液白细胞增多	脑脊液白细胞增多,白细胞增高,白细胞增多
脑脊液白细胞常大于4000/mm3	脑脊液白细胞增多
脑脊液结核分枝杆菌培养阳性	脑脊液阳性
脑脊液葡萄糖降低	脑脊液葡萄糖降低
脑脊液蛋白含量增高	脑脊液蛋白增高
脑脊液鲎（Limalus）试验阳性	脑脊液阳性
脑脊液鼻漏	脑脊液鼻漏
脑膜刺激征	脑膜刺激征
脑膜刺激征阳性	脑膜刺激征阳性,脑膜刺激征
脑膜刺激症	脑膜刺激症,脑膜刺激征
脑膜刺激症状	脑膜刺激症状,脑膜刺激征
脑膜炎	脑膜炎
脑膜炎征象	脑膜炎征象
脑膜炎表现	脑膜炎
脑膜脑炎症状	脑膜脑炎症状
脑钙化	脑钙化
脓尿	脓尿
脓性心包积液	心包积液
脓性恶臭白带	白带恶臭
脓毒症	脓毒症
脓涕	脓涕
脓疱	脓疱
脓疱病	脓疱病,脓疱
脓痰	咳痰,脓痰
脓肿	脓肿
脓肿不易破溃	脓肿
脓胸	脓胸
脓臭痰	脓臭痰
脓血便	脓血便
脓血性白带	阴道分泌物异常,脓
脓血痰	血痰,咳血痰,脓
脚尖着地	脚尖着地
脱出痔块坏死	痔块坏死,痔块脱出
脱出痔块水肿	痔块脱出,痔块水肿
脱出痔块淤血	痔块脱出,痔块淤血
脱发	脱发
脱屑	脱屑
脱水	脱水
脱水症状	脱水
脱皮	脱皮
脸圆胖	脸圆胖
脸色苍白	脸色苍白
脾中度肿大	脾大,脾肿大
脾功能亢进	脾功能亢进
脾区压痛	脾区压痛,脾触痛
脾区叩痛	脾触痛,脾区叩痛
脾区摩擦音	脾区摩擦音
脾区疼痛	脾区疼痛,脾触痛
脾压痛阳性	脾触痛,脾阳性
脾增大	脾增大,脾大
脾大	脾大
脾气暴躁	脾气暴躁,暴躁
脾肿大	脾肿大,脾大
脾脏触诊稍坚硬	脾脏触诊稍坚硬
脾触痛	脾触痛
脾轻度肿大	脾肿大,脾大
腊肠指	腊肠指
腊肠样肠管	肠管腊肠样
腋下淋巴结肿大	腋下淋巴结肿大,腋下肿大,淋巴结肿大
腋下闻及连续性血管杂音	腋下杂音,血管杂音
腋前线处包块	腋前线处包块
腋毛减少	腋毛减少
腋毛稀少	腋毛稀少
腋毛稀疏	腋毛稀疏
腋毛脱落	腋毛脱落
腋窝淋巴结肿大	腋窝淋巴结肿大,腋窝黄豆大小淋巴结
腋窝色素沉着	腋窝色素沉着
腋窝雀斑	腋窝雀斑
腓反射阳性	腓反射阳性
腓肠肌假性挛缩	腓肠肌挛缩
腓肠肌假性肥大	腓肠肌肥大
腓肠肌压痛	腓肠肌压痛,腓肠肌痛
腓肠肌局部压痛	腓肠肌痛,腓肠肌压痛
腓肠肌局部疼痛	腓肠肌痛,腓肠肌疼痛
腓肠肌疼痛	腓肠肌疼痛,腓肠肌痛
腓肠肌绷紧	腓肠肌绷紧
腔前黏液性水肿	水肿
腔隙综合征	腔隙综合征
腕下垂	腕下垂
腕关节不能伸直	腕关节不能伸直
腕关节乏力	腕关节乏力,乏力
腕关节压痛拒按	腕痛,关节痛
腕关节周围肌无力	四肢无力,肌无力
腕关节周围肌萎缩	肌萎缩
腕关节屈曲	腕关节屈曲
腕关节桡侧疼痛	腕关节疼痛,腕关节痛,关节痛,腕痛
腕关节活动受限	腕关节活动受限
腕关节活动障碍	关节活动障碍,关节功能障碍,腕障碍,腕关节活动障碍
腕关节疼痛	关节疼痛,腕痛,关节痛,腕关节疼痛
腕关节皮下瘀斑	腕关节瘀斑,皮下瘀斑,腕关节皮下瘀斑
腕关节肿胀	腕关节肿胀
腕关节胀痛	关节痛,腕痛,腕关节胀痛
腕外展屈曲不能	腕屈曲,腕不能,腕外展
腕尺侧Tinel征阳性	腕阳性
腕尺侧疼痛不适	腕痛,腕不适
腕强直	腕强直
腕管综合征	腕管综合征
腕背部肌腱囊性肿块	肌腱肿块
腕部下垂	腕部下垂
腕部僵硬	腕部僵硬
腕部压痛明显	腕部压痛,腕部明显
腕部屈曲	腕部屈曲
腕部慢性劳损症状	劳损
腕部正中神经Tinel征阳性	腕部阳性,神经阳性
腕部畸形	腕部畸形
腕部疼痛	腕部疼痛
腕部肿胀	腕部肿胀
腕部运动障碍	运动障碍,腕部运动障碍,运动异常
腘动脉搏动不能扪及	腘动脉搏动不能扪及
腘动脉搏动减弱	腘动脉搏动减弱
腥臭味便	便腥臭味
腭弓圆形突起	腭弓圆形,腭弓突起
腭弓颗粒状瘤	腭弓瘤,腭弓颗粒状
腭扁桃体肥大	扁桃体肥大
腭裂	腭裂
腭部穿孔	腭部穿孔
腭部肿块	腭部肿块
腭高耳低	腭高耳低
腮腺压痛	腮腺疼痛,腮腺压痛
腮腺导管开口红肿	腮腺导管开口红肿
腮腺肿大	腮腺肿大
腮腺肿痛	腮腺肿痛,腮腺肿大,腮腺疼痛
腮腺肿胀	腮腺肿胀,腮腺肿大
腮腺表面灼热感	腮腺表面灼热感,表面灼热感,腮腺灼热感
腰大肌试验（Psoas征）阳性	腰大肌试验阳性
腰椎侧凸	腰椎侧凸
腰椎前凸	腰椎前凸
腰椎棘突旁压痛	腰椎压痛,棘突压痛
腰椎棘突间压痛	棘突间压痛,腰椎棘突间压痛,腰椎压痛
腰椎椎体内局限性高密度硬化区	腰椎硬化,腰椎高密度
腰椎活动受限	腰椎活动受限
腰椎过度前凸	腰椎前凸
腰疼	腰疼,腰痛
腰痛	腰痛
腰痛向下肢放射	肢放射,腰痛
腰痛放射到下腹部	腰痛,下腹部放射
腰痛放射到大腿内侧	腰痛,大腿放射
腰痛放射至同侧睾丸	腰痛,睾丸放射
腰痛放射至同侧腹股沟	腰痛,腹股沟放射
腰肋痛	腰肋痛
腰胁部皮肤瘀斑	皮肤出血点,腰胁部瘀斑,腰胁部皮肤瘀斑,皮肤瘀斑
腰背疼痛	腰背痛,腰背疼痛
腰背痛	腰背痛
腰背肌痛	肌痛,腰背肌痛,腰背痛
腰背部压痛	腰背部压痛,腰部压痛
腰背部压痛点有放射痛	腰背痛
腰背部固定压痛点	腰背部固定压痛
腰背部疼痛	腰背部疼痛,腰背痛
腰背部静脉曲张	静脉曲张,腰背部静脉曲张
腰背酸痛	腰背酸痛,腰背痛
腰腹疼痛	腰腹疼痛
腰腹胀痛	腰腹疼痛,腰腹胀痛
腰腹部疼痛	腰腹部疼痛,腰腹疼痛
腰腹部肿块	腰腹部肿块,腹肿块
腰腿痛	腰腿痛
腰部不适	腰部不适
腰部压痛	腰部压痛
腰部发僵	腰部发僵
腰部固定点压痛	腰部固定,腰部压痛
腰部局部肌肉紧张	肌肉紧张,腰部紧张
腰部束带感	腰部束带感
腰部活动受限	腰部活动受限
腰部疼痛	腰背痛,腰部疼痛
腰部肋脊处血管杂音	腰部血管杂音,血管杂音,腰部杂音
腰部肌压痛	肌痛,腰部压痛,腰部肌压痛
腰部肌痉挛	痉挛,肌痉挛
腰部肿块	腰部肿块,腰部肿物
腰部肿物	腰部肿物
腰部血管杂音	腰部杂音,血管杂音,腰部血管杂音
腰部酸痛	腰背痛,腰部酸痛
腰部酸胀	腰部酸胀
腰部钝痛	腰部钝痛,腰痛
腰部隐痛	腰背痛,腰部隐痛
腰部隐痛不适	腰部隐痛,腰部不适,腰背痛
腰酸	腰酸
腰酸乏力	乏力,腰酸
腰酸痛	腰痛,腰酸,腰酸痛
腰酸胀痛	腰酸胀痛
腰酸背痛	腰酸背痛
腰骶牵涉痛	腰骶牵涉痛,腰骶疼痛
腰骶部下坠感	腰骶部下坠感
腰骶部疼痛	腰骶疼痛,腰骶部疼痛
腰骶部酸痛	腰骶部酸痛,腰骶疼痛
腰骶部酸胀	腰骶部酸胀
腱反射亢进	反射亢进,腱反射亢进
腱反射减弱	腱反射减弱
腱反射减退	腱反射减弱,腱反射减退
腱反射异常	腱反射异常
腱反射改变	腱反射改变
腱反射活跃	腱反射活跃
腱反射消失	腱反射消失
腱反射较活跃	腱反射较活跃
腹主动脉区闻及血管杂音	腹闻及血管杂音,主动脉闻及血管杂音
腹主动脉旁淋巴结肿大	主动脉肿大,腹肿块,淋巴结肿大,主动脉淋巴结肿大,腹包块
腹内肿块	腹内肿块,腹包块,腹肿块
腹压增加下不自主溢尿	溢尿,腹压不自主
腹围小于孕周	腹围小于孕周
腹型肥胖	腹型肥胖
腹壁压痛	腹部压痛,腹壁压痛
腹壁反射保留	腹壁反射保留
腹壁反射减弱	腹壁反射减弱
腹壁反射消失	腹壁反射消失
腹壁可见外翻的膀胱粘膜	膀胱外翻
腹壁手术切口处肿块	腹壁肿块,切口处肿块,手术肿块
腹壁手术切口处逐渐膨隆	腹壁膨隆,切口处膨隆,手术膨隆
腹壁手术瘢痕	腹壁手术瘢痕
腹壁扪及胎体	腹壁扪及胎体
腹壁揉面感	腹壁揉面感
腹壁正中线（白线）处突出肿块	白线肿块,腹壁突出,正中线肿块,正中线突出,腹壁肿块,白线突出
腹壁肌群痛性痉挛	痉挛
腹壁肿胀	腹部不适,腹胀,腹壁肿胀
腹壁静脉怒张	静脉怒张,腹壁静脉怒张
腹壁静脉曲张	腹壁静脉曲张
腹壁高度紧张	腹壁紧张
腹式呼吸减弱	呼吸运动减弱,腹式呼吸减弱
腹式呼吸消失	腹式呼吸消失
腹式呼吸运动减弱	腹式呼吸减弱,腹式呼吸运动减弱,呼吸运动减弱
腹式呼吸运动消失	腹式呼吸运动消失,腹式呼吸消失
腹水	腹水
腹水嗜酸性细胞多	腹水
腹水征阳性	腹水征阳性,腹水征
腹泻	腹泻
腹泻与便秘交替	腹泻,便秘
腹泻便秘交替	便秘,腹泻
腹泻频繁	腹泻
腹痛	腹痛
腹痛与头痛交替发生	腹痛,头痛
腹痛从局部扩散至全腹	腹痛
腹痛从病灶区扩散至全腹	腹痛
腹痛便后缓解	腹痛
腹痛发作与进食量呈正比	食量发作,腹痛
腹痛发生在月经周期的末1周	腹痛
腹痛向右肩背部放射	右肩放射,背部放射,腹痛
腹痛向背部放射痛	腹痛
腹痛和头痛同时出现	腹痛,头痛
腹痛平卧加重	腹痛,平卧加重
腹痛持续加剧且范围扩大	腹痛
腹痛放射至右肩部	腹痛
腹痛放射至肩背部	腹痛,背部放射,肩放射
腹痛放射至腰背部	腹痛,腰背部放射
腹痛涉及背部	腹痛
腹痛突然暂时减轻	腹痛
腹痛进食后可缓解	腹痛
腹痛随孕周增加而加剧	孕周增加,孕周加剧,腹痛
腹痛餐后加剧	腹痛
腹肌“木板样”强直	腹肌木板样,腹肌强直
腹肌木板样强直	腹肌木板样,腹肌强直
腹肌紧张	腹肌紧张
腹肌紧张不明显	腹肌紧张
腹股沟不适	腹股沟不适
腹股沟区坠胀感	腹股沟区坠胀感
腹股沟区淋巴结肿大	腹股沟区肿大,腹股沟区淋巴结肿大,淋巴结肿大
腹股沟区深部压痛	腹股沟疼痛
腹股沟区疼痛	腹股沟疼痛,腹股沟区疼痛
腹股沟区肿块	腹股沟区肿块,腹股沟肿物
腹股沟压痛	腹股沟疼痛,腹股沟压痛
腹股沟囊性肿块	腹股沟肿物,腹股沟肿块
腹股沟处疼痛	腹股沟疼痛
腹股沟海绵状肿块	腹股沟肿物,腹股沟海绵状,腹股沟肿块
腹股沟淋巴结疼痛	淋巴结疼痛,腹股沟淋巴结疼痛,腹股沟疼痛
腹股沟淋巴结肿大	腹股沟淋巴结肿大,腹股沟肿物,淋巴结肿大
腹股沟淋巴结肿大伴压痛	腹股沟疼痛,淋巴结压痛,淋巴结肿大,腹股沟肿物,腹股沟淋巴结肿大,淋巴结疼痛
腹股沟淋病结肿大	腹股沟淋病结肿大,腹股沟肿物
腹股沟肿物可回纳	腹股沟肿物
腹股沟色素沉着	腹股沟色素沉着
腹股沟酸痛	腹股沟疼痛,腹股沟酸痛
腹股沟雀斑	腹股沟雀斑
腹股沟韧带下方卵圆窝处一半球形突起	腹股沟突起,韧带半球形,卵圆窝处半球形,韧带突起,腹股沟半球形,卵圆窝处突起
腹股沟韧带下方局部疼痛	腹股沟疼痛,韧带疼痛
腹胀	腹胀,腹部不适
腹胀不对称	腹胀,腹部不适,腹胀不对称
腹胀加重	腹胀加重,腹部不适,腹胀
腹胀进行性加重	腹部不适,腹胀,腹胀加重
腹胁肋部疼痛	腹痛,腹胁肋部疼痛,腹疼
腹腔内出血	腹腔内出血
腹腔内出血症状	腹腔内出血症状,腹腔内出血,症状内出血
腹腔内少量出血	腹腔内出血
腹腔积气	腹腔积气
腹腔积液	腹腔积液
腹腔积液征	腹腔积液征,腹腔积液
腹腔镜检查可见卵巢表面破裂，有活动性出血	表面破裂,出血,卵巢破裂
腹膜刺激征	腹膜刺激征
腹膜刺激征不明显	腹膜刺激征不明显,腹膜刺激征
腹膜刺激征象不明显	腹膜刺激征不明显,腹膜刺激征
腹膜刺激征阳性	腹膜刺激征,腹膜刺激征阳性
腹膜后淋巴管平滑肌瘤	平滑肌瘤
腹膜炎	腹膜炎
腹膜炎体征	腹膜炎体征
腹膜炎征象	腹膜炎
腹部下坠感	腹部下坠感
腹部不再增大	腹部增大,腹部不再
腹部不对称	腹部不对称
腹部不适	腹部不适
腹部不适感	腹部不适感
腹部剧烈疼痛	腹部疼痛,腹痛
腹部剧烈绞痛	腹痛,腹部绞痛
腹部包块	腹部包块,腹包块
腹部包块叩诊实音	腹包块,腹部包块
腹部压痛	腹部压痛
腹部压痛及反跳痛	腹部反跳痛,腹部压痛,痛
腹部压迫感	腹部压迫感,腹部不适
腹部反跳痛	腹部压痛,痛,腹部反跳痛
腹部叩诊呈鼓音	腹部叩诊鼓音,叩诊鼓音,腹部鼓音
腹部叩诊均匀鼓音	腹部叩诊鼓音
腹部囊性肿块	腹包块,腹肿块,腹部肿块
腹部存在搏动性肿物	腹肿块,腹部存在,腹部肿物
腹部局部皮肤凹陷性水肿	皮肤水肿,腹部水肿,皮肤肿胀
腹部局限性隆起	腹部隆起
腹部平坦	腹部平坦
腹部张力高	腹部高,张力高,腹部张力高
腹部扪及包块	腹部包块,腹部扪及,腹包块
腹部持续钝痛	腹痛
腹部损伤	腹部损伤
腹部揉面感	腹部揉面感
腹部明显膨隆	腹部膨隆,腹部明显,腹包块
腹部有局部隆起	腹部隆起
腹部有气过水声	腹部气过水声,气过水声
腹部条索状包块	腹部条索状,腹部包块,腹包块
腹部柔软	腹部柔软
腹部气过水声	气过水声
腹部沉重	腹部不适,腹部沉重
腹部淋巴结肿大	腹肿块,腹部淋巴结肿大,腹包块,淋巴结肿大
腹部牵拉感	腹部牵拉感
腹部疼痛	腹痛,腹部疼痛
腹部皮肤瘀斑	腹部皮肤瘀斑,皮肤出血点,腹部瘀斑,皮肤瘀斑
腹部移动性包块	腹包块,腹部包块
腹部移动性浊音	移动性浊音,移动性浊音阳性,腹水,腹部移动性浊音
腹部绞痛	腹部绞痛,腹痛
腹部肌紧张	腹部肌紧张
腹部肿块	腹肿块,腹部肿块,腹包块
腹部肿物	腹肿块,腹部肿物
腹部肿物不可回纳	腹部肿物,腹部不可,腹肿块
腹部肿物变硬	腹部肿物,腹部变硬,腹肿块
腹部肿物可回纳	腹肿块,腹部肿物
腹部肿物增大伴疼痛	腹部肿物,腹部疼痛,腹肿块,腹部增大,腹痛
腹部肿物明显压痛	腹部压痛,腹肿块,腹部明显,腹部肿物
腹部胀满	腹部胀满,腹部不适,腹胀
腹部胀痛	腹痛,腹部胀痛
腹部腊肠样肿块	腹部肿块,腹包块,腹肿块
腹部膨隆	腹包块,腹部膨隆
腹部血管杂音	腹部血管杂音,腹部杂音,血管杂音
腹部触及压痛性肿块	腹部触及,腹部压痛
腹部触及囊性肿块	腹肿块,腹包块,腹部肿块,腹部触及
腹部触及表面光滑的包块	腹包块,腹部触及,腹部包块,腹部表面光滑
腹部触诊揉面感	腹部触诊揉面感
腹部触诊柔韧感	腹部触诊柔韧感
腹部轻压痛	腹部轻压痛
腹部钝痛	腹部钝痛,腹痛
腹部阵发性绞痛	腹痛,腹部绞痛
腹部阵发绞痛	腹痛,腹部绞痛
腹部隐痛	腹痛,腹部隐痛
腹部饱满	腹部饱满
腹部饱胀	腹部不适,腹部饱胀,腹胀
腹部饱胀感	腹部饱胀感
腹部高度膨隆	腹包块,腹部膨隆
腺样体充血	腺样体充血
腺样体肿大	腺样体肿大
腺样体覆有渗出物	腺样体渗出物
腺病毒阳性	腺病毒阳性
腾喜龙激发试验阳性	激发试验阳性
膀胱不能排空	膀胱不能排空
膀胱充盈时放射性排尿	膀胱充盈
膀胱刺激征	膀胱刺激征
膀胱刺激症状	膀胱刺激症状,膀胱刺激征
膀胱前壁缺如	膀胱前壁缺如,膀胱缺如
膀胱功能障碍	膀胱功能障碍
膀胱区偏右侧肿块压痛	膀胱区肿块,膀胱区压痛
膀胱区偏右侧触及肿块	膀胱区肿块,膀胱区触及
膀胱自主神经功能障碍	膀胱自主神经功能障碍,膀胱功能障碍,自主神经障碍,自主神经功能障碍
膀胱镜下见膀胱内炎症改变	膀胱改变
膀胱镜下见膀胱有出血	膀胱出血
膀胱镜下见膀胱黏膜弥漫性水肿	黏膜水肿,膀胱水肿
膀胱镜下见膀胱黏膜片状出血	黏膜出血,膀胱出血
膀胱黏膜见黄色肿瘤样结节	肿瘤,膀胱肿瘤,黏膜黄色,膀胱黄色
膈肌上升	膈肌上升
膈肌反常运动	膈肌反常运动,运动反常
膝关节内外侧间隙疼痛	膝关节痛,膝关节疼痛
膝关节屈曲	膝关节屈曲,膝关节弯曲
膝关节屈曲挛缩	膝关节弯曲,膝关节屈曲,膝关节挛缩
膝关节弹响	膝关节弹响
膝关节无力	膝关节无力,无力
膝关节活动受限	膝关节活动受限
膝关节渗出	膝关节渗出
膝关节滑膜肿胀增厚	膝关节增厚,膝关节肿胀
膝关节疼痛	膝关节疼痛,关节痛,膝关节痛
膝关节痛	膝关节痛,膝关节疼痛
膝关节积液	膝关节积液
膝关节绞锁	膝关节绞锁
膝关节肿胀	膝关节肿胀
膝内翻	膝内翻
膝前内侧疼痛	膝痛,膝疼痛
膝前内侧部位关节线上方压痛	关节压痛,膝关节压痛,部位压痛,关节痛
膝前部内侧慢性疼痛不适	膝痛,膝疼痛,膝不适
膝反射比踝反射消失早	踝反射消失,膝反射消失
膝反射消失	膝反射消失
膝外翻	膝外翻
膝腱反射减退	膝腱反射减退
膝部梭形肿胀	膝部肿胀
膝部疼痛	膝部疼痛
臀部不适	臀部不适
臀部及梨状肌紧张肿胀	臀部肿胀,肌紧张,臀部梨状
臀部明显压痛	臀部明显,臀部疼痛
臀部疱疹	臀部疱疹,疱疹
臀部疼痛	臀部疼痛
臀部红斑	红斑,臀部红斑
臀部酸痛	臀部酸痛,臀部疼痛
臀部酸胀疼痛	臀部酸胀,臀部疼痛
臂丛神经牵拉试验阳性	臂丛神经牵拉试验阳性
臂丛神经牵拉试验阳性（Eaton试验）	臂丛神经牵拉试验阳性
自主活动消失	自主活动消失
自主神经功能紊乱	自主神经功能紊乱,自主神经障碍
自主神经功能障碍	自主神经功能障碍,自主神经障碍
自主神经症状	自主神经症状
自主神经障碍	自主神经障碍
自主运动障碍	运动障碍,运动异常
自动症	自动症
自发性关节出血	关节出血
自发性气胸	气胸
自发性皮肤出血	皮肤出血
自发性言语受限	言语受限
自发性骨折	骨折
自发性黏膜出血	黏膜出血
自暴自弃	自暴自弃
自杀	自杀
自杀念头	自杀念头
自罪感	自罪感
自觉畏光	自觉畏光
自负	自负
自身免疫性疾病	自身免疫性疾病
臭鼻症	臭鼻症
舌下皱襞红肿	皱襞红肿,舌下皱襞红肿,舌下红肿,舌肿大
舌下神经麻痹	舌下神经麻痹
舌下红肿	舌下红肿,舌肿大
舌下腺肿大	舌肿大,舌下腺肿大
舌乳头萎缩	舌乳头萎缩
舌体肥大	舌体肥大,舌大
舌后1/3味觉缺失	舌后味觉缺失
舌咬伤	舌咬伤
舌咽神经麻痹	舌咽神经麻痹
舌大	舌大
舌大而宽厚	舌大
舌根部疼痛	舌根疼痛,舌根部疼痛
舌根部肿物	舌根部肿物
舌炎	舌炎
舌痛	舌痛
舌肌强直发作	肌强直,肌肉强直,舌发作
舌肌萎缩	舌肌萎缩,肌萎缩
舌背红斑	红斑
舌腭弓上方隆起	舌腭弓隆起
舌腭弓充血	舌腭弓充血
舌腭弓红肿	舌腭弓红肿
舌腭弓隆起	舌腭弓隆起
舌苔厚腻	舌苔厚腻
舌裂	舌裂
舌震颤	舌震颤
舌面光滑	舌面光滑
舌面干	舌面干
舌麻木	舌麻木
舒张压降低	舒张压降低
舒张压高于130mmHg	高血压
舒张期奔马律	心脏杂音,奔马律
舞蹈-手足徐动样不自主运动	手足徐动,不自主运动
舞蹈手足徐动症	舞蹈手足徐动症
舞蹈样不自主运动	不自主运动
舞蹈样动作	动作舞蹈样
舞蹈病	舞蹈病
舞蹈病样运动	舞蹈病
舞蹈症	舞蹈病,舞蹈症
舟状头	舟状头
舟状头畸形	舟状头,舟状头畸形
舟状窝囊性隆起	舟状窝隆起
舟状腹	舟状腹
色觉异常	色觉异常
苦笑面容	面容苦笑
苯丙氨酸/酪氨酸（Phe/Tyr）>2.0	嗜酸性粒细胞增多
苯丙氨酸羟化酶基因（PAH）突变	基因突变
草莓舌	草莓舌
荨麻疹	荨麻疹
药物滥用	药物滥用
药物难以控制的高血压	高血压,药物难以
萎缩性胃炎	胃炎
萎靡	萎靡
营养不良	营养不良
营养障碍	营养障碍,营养不良
落日征	落日征
落日现象	落日现象
落日目征	落日目征
葡萄胎妊娠史	葡萄胎妊娠史,葡萄胎
葡萄膜炎	葡萄膜炎
虚弱感	虚弱,虚弱感
虚弱无力	无力
虚胖	虚胖
虚脱	虚弱,虚脱
虫体钙化	虫体钙化
虹膜平坦	虹膜平坦
虹膜炎	虹膜炎
虹膜睫状体炎	葡萄膜炎,虹膜睫状体炎
虹膜粟粒状小结节	虹膜粟粒状,虹膜小结节
虹膜缺失	虹膜缺失
虹膜色素减少	虹膜减少,虹膜色素减少,色素减少
虹膜萎缩	虹膜萎缩
虹视	虹视
蚁走感	蚁走感
蛋白尿	蛋白尿
蛋白尿≥5.0g/24h	蛋白尿
蛋花样便	便蛋花样
蛛网膜下腔出血症状	蛛网膜下腔出血
蛲虫卵阳性	蛲虫卵阳性
蜘蛛痣	蜘蛛痣
蝶形红斑	红斑
蝶鞍扩大	蝶鞍扩大
蝶鞍破坏	蝶鞍破坏
蝶骨发育不良	蝶骨发育不良,发育不良,发育障碍
血17‐羟孕酮（17‐OHP）升高	孕酮增高
血CA125升高	血CA125升高
血CA125增高	血CA125升高
血CEA增高	cea升高
血CRP升高	CRP升高
血C反应蛋白升高	c反应蛋白升高
血HCG升高	血HCG升高
血丝痰	咳血痰,血丝痰
血中分离钩端螺旋体阳性	血中分离,血中阳性
血中性粒细胞升高	中性粒细胞增多,中性粒细胞升高,血中性粒细胞升高
血便	血便
血催乳素升高	血催乳素升高
血单核细胞增高	单核细胞增多
血压下降	低血压,血压降低,血压下降
血压不稳	血压不稳,血压波动
血压中等程度增高	血压增高,高血压,血压升高
血压偏低	血压偏低
血压偏高	血压偏高
血压升高	血压增高,血压升高,高血压
血压增高	血压增高,血压升高,高血压
血压忽高忽低	血压忽高忽低,血压波动
血压持续升高	血压增高,血压升高,高血压
血压控制困难	血压控制困难
血压波动大	血压波动,血压大
血压测不出	血压测不出
血压突然升高	高血压,血压增高,血压升高
血压轻度升高	高血压,血压增高,血压升高
血压降低	低血压,血压降低
血压骤降	血压骤降
血压高	血压高
血嗜酸性粒细胞增多	血嗜酸性粒细胞增多,嗜酸性粒细胞升高,嗜酸性粒细胞增多,嗜酸性粒细胞增高,血嗜酸性粒细胞升高
血嗜酸细胞增多	血嗜酸细胞增多
血培养分离出鼠疫耶尔森菌	鼠疫
血培养阳性	血培养阳性
血容量不足表现	血容量表现,血容量不足
血容量减少	血容量减少
血小板减少	血小板减少
血小板增高	血小板增多,血小板增高
血小板计数减少	血小板计数减少
血尿	血尿
血尿素氮升高	血尿素氮升高
血尿素氮降低	血尿素氮降低
血尿酸升高	血尿酸升高
血尿酸降低	血尿酸降低
血异型淋巴细胞增高	血淋巴细胞增高,淋巴细胞增多
血性恶露时间延长	恶露时间延长
血性白带	阴道分泌物异常
血性胸水	胸水
血栓形成	血栓
血栓性静脉炎	静脉炎
血栓栓塞性疾病	血栓
血栓部位压痛	血栓,部位压痛
血气胸	血气胸
血氧饱和度降低	低氧血症,紫绀,血氧饱和度降低
血氨升高	血氨升高
血水便	血水便
血水样便	稀便,水样便,血水样便,血水便
血沉加快	血沉加快,血沉增快
血沉升高不显著	血沉增高
血沉增快	血沉加快,血沉增快
血沉增高	血沉增高
血沉显著升高	血沉增高
血浆儿茶酚胺增高	血浆增高
血浆渗透压升高	血浆渗透压升高
血浆渗透压降低	渗透压降低,血浆渗透压降低
血浆甲状腺素浓度上升	甲状腺素上升,血浆上升
血浆肾素活性升高	血浆肾素增高
血涂片球形细胞增多	细胞增多
血涕	血涕
血液pH值升高	血液增多
血液中乳酸含量显著增高	血液增多
血淀粉酶增高	血淀粉酶增高,血淀粉酶升高
血淋巴细胞减少	血淋巴细胞减少,淋巴细胞减少
血淋巴细胞增高	淋巴细胞增多,血淋巴细胞增高
血清25-（OH)D3降低	血清降低
血清ASO升高	血清增高,血清升高
血清GH升高	血清升高,血清增高
血清hCG水平增高	血清增高,血清升高
血清hCG水平持续增高	血清升高,血清增高
血清HIV p24抗原阳性	血清阳性
血清HIV RNA抗体阳性	人类免疫缺陷病毒抗体阳性,血清阳性
血清IGF-1升高	血清增高,血清升高
血清IgG升高	血清升高,血清增高
血清IgM升高	血清增高,血清升高
血清丙氨酸氨基转移酶升高	血清增高,血清升高
血清丙氨酸转氨酶增高	血清增高,转氨酶升高,血清升高,血清转氨酶升高
血清中病毒抗体滴度升高	血清升高,抗体滴度增高
血清促性腺激素水平升高	血清增高,血清升高
血清催乳素（PRL）升高	血清增高,血清升高
血清免疫学反应阳性	血清免疫学反应阳性
血清嗜异性凝集试验（HAT）阳性	血清阳性
血清性激素水平升高	血清增高,血清升高
血清总胆红素升高	血清总胆红素升高
血清抗α‐烯醇化酶抗体阳性	血清阳性
血清抗乙酰胆碱受体升高	血清增高,血清升高
血清抗甲状腺过氧化物酶抗体（TPO‐Ab）升高	血清升高
血清抗神经节苷脂阳性	血清阳性
血清曲菌特异性IgE阳性	血清阳性
血清氯	血清氯
血清水痘病毒IgM抗体阳性	血清阳性
血清泌乳素增高	血清增高,血清升高
血清淀粉酶升高	血清升高,血清增高
血清游离三碘甲状腺原氨酸（FT3）升高	FT3增高,甲状腺素升高,游离三碘甲状腺原氨酸升高,血清升高,血清增高,血清甲状腺激素升高
血清游离甲状腺素（FT4）升高	FT4增高,血清升高,甲状腺素升高
血清烟曲菌IgG阳性	血清阳性
血清特异性病毒抗体阳性	血清阳性,特异性病毒抗体阳性
血清甲状旁腺素降低	血清降低
血清甲状旁腺素（PTH）增高	血清增高,血清升高
血清甲状腺激素升高	血清升高
血清甲状腺激素水平升高	血清增高,血清升高
血清疱疹病毒抗体阳性	血清阳性
血清结核抗体阳性	血清阳性
血清肌酐增高	血清肌酐升高,血清肌酐增高
血清胆红素升高	血清胆红素升高,血清增高,血清升高,胆红素升高
血清胡萝卜素升高	胡萝卜素升高,血清增高,血清升高,血清胡萝卜素升高
血清脂肪酶增高	血清增高,血清升高,脂肪酶增高
血清腺病毒抗体阳性	血清阳性,腺病毒阳性
血清蛋白电泳示白蛋白减少	白蛋白降低
血清转氨酶升高	血清转氨酶升高
血清酸性磷酸酶增高	血清升高,酸性磷酸酶增高,血清增高
血清钠	血清钠
血清钠<135mmol／L	血清钠
血清钾	血清钾
血清锌降低	血清降低,血清锌降低,低锌血症
血清降钙素原升高	血清降钙素原升高
血痰	血痰,咳血痰
血白细胞减少	白细胞减少
血白细胞增高	血白细胞升高,白细胞计数升高,血白细胞增高
血白蛋白减少	血白蛋白减少,白蛋白降低
血碱性磷酸酶升高	碱性磷酸酶增高,血碱性磷酸酶升高,碱性磷酸酶升高
血磷增高	血磷增高
血管内皮功能受损	功能受损
血管性紫癜	紫癜
血管栓塞	血管栓塞
血管炎(病)	血管炎
血管痣	血管痣
血管神经性水肿	血管神经性水肿
血管运动功能障碍	运动功能障碍,血管功能障碍,血管运动功能障碍,运动异常
血管钙化	血管钙化
血精	血精
血糖值升高与尿糖值升高不成比例	尿葡萄糖阳性,尿糖阳性
血糖升高发生在下午及晚上	高血糖,血糖增高
血糖增高	血糖增高,高血糖
血糖降低	低血糖,血糖降低
血红细胞比容升高	红细胞比容增高
血红蛋白下降	血红蛋白下降
血红蛋白增高	血红蛋白增高
血红蛋白大于220g/L	血红蛋白增高
血红蛋白尿	血红蛋白尿
血红蛋白降低	血红蛋白降低,血红蛋白减少,贫血
血细胞比容增高	血细胞比容升高,血细胞比容增高
血肿	血肿
血肿周围组织肿胀增厚	组织肿胀,血肿,组织增厚
血胆固醇降低	胆固醇降低,血胆固醇降低
血胸	血胸
血脂增高	血脂增高
血腺病毒抗原阳性	腺病毒阳性
血色素下降	贫血,血色素下降
血酮升高	血酮升高
血钙增高	血钙增高
血钙降低	血钙降低
血钠降低	血钠低,血钠降低
血钾过多	血钾过多
行为失常	行为失常
行为奇特	行为奇特
行为幼稚	行为幼稚
行为异常	行为异常
行为怪异	行为怪异
行为损害	行为损害
行为改变	行为改变
行为障碍	行为障碍
行动困难	行动困难
行动懒散	行动懒散
行动笨拙	行动笨拙
行走不便	行为障碍,行走不便
行走后下肢肿胀加重	下肢肿胀,下肢加重,肢体肿胀
行走呈跨阈步态	跨阈步态
行走困难	行为障碍,行走困难
行走时失平衡	失平衡
行走时足跟着地	足跟着地
行走易跌倒	行走易跌倒,猝倒发作,易跌倒
表情呆滞	表情呆滞,呆滞
表情淡漠	表情淡漠,淡漠,情感障碍
表情焦虑	焦急,焦虑,表情焦虑
表情苦痛	表情苦痛
表皮下红色细线	皮下红色
袜套样感觉	感觉袜套样
被动牵拉受累肌肉出现疼痛（肌肉被动牵拉试验阳性）	肌肉痛,肌肉出现,肌肉牵拉,肌肉受累,肌痛,肌肉疼痛,肌肉阳性,肌肉被动
被害妄想	妄想
被害幻想	幻想
规则子宫收缩	子宫收缩
规律性下腹痛	下腹痛,腹痛
觅乳困难	拒食,觅乳困难
视乳头充血	视乳头充血
视乳头凹陷明显	视乳头明显,视乳头凹陷
视乳头水肿	视乳头水肿
视乳头苍白	视乳头苍白
视乳头苍白萎缩	视乳头苍白萎缩
视力下降	视力差,视力下降
视力减退	视力减退,视力下降
视力受损	视力受损
视力模糊	视力模糊,视力障碍
视力降低	视力降低
视力障碍	视力障碍
视幻觉	视幻觉
视物不清	视力差,视物不清
视物变形	视物变形
视物旋转	视物旋转
视物昏花	视物昏花
视物模糊	视力下降,视物模糊
视盘周围神经纤维层缺损	视盘缺损,神经纤维缺损
视盘损害	视盘损害
视盘水肿	视盘水肿
视盘苍白	视盘苍白
视神经乳头水肿	水肿,视神经乳头水肿
视神经乳头萎缩	视神经乳头萎缩
视神经炎	视神经炎
视神经萎缩	视神经萎缩
视空间功能障碍	视空间障碍,视空间功能障碍
视空间能力障碍	视空间能力障碍,视空间障碍
视网膜上可见单一或多发灰白色突起	视网膜灰白色,视网膜突起
视网膜出血	视网膜出血
视网膜动脉狭窄	视网膜动脉狭窄
视网膜樱桃红点	视网膜樱桃红点
视网膜渗出物	视网膜渗出物
视网膜病变	视网膜病变
视网膜脉络膜炎	视网膜脉络膜炎,视网膜炎
视网膜色素变性	色素变性,视网膜色素变性,视网膜变性
视网膜血管扩张	视网膜血管扩张,视网膜扩张,血管扩张
视觉先兆性头痛	视觉先兆性头痛
视觉异常	视觉异常
视觉模糊	视觉模糊,视觉障碍
视觉障碍	视觉障碍
视野模糊	视野模糊
视野缩小	视野收缩,视野缩小
视野缺损	视野缺损
视野障碍	视野障碍
觉醒障碍	觉醒障碍
角巩膜缘溃疡	巩膜溃疡
角弓反张	角弓反张
角膜上皮水肿	角膜上皮水肿
角膜下颌反射	角膜下颌反射,下颌反射,角膜反射
角膜反射减弱	角膜反射,角膜减弱
角膜反射消失	角膜消失,角膜反射
角膜反射迟钝	角膜迟钝,角膜反射
角膜外露	角膜外露
角膜干燥	角膜干燥
角膜感觉减退	角膜感觉减退,感觉减退,感觉障碍,角膜减退
角膜混浊	角膜混浊
角膜溃疡	角膜溃疡
角膜炎	角膜炎
角膜痛觉缺失	痛觉缺失,角膜痛觉缺失
角膜穿孔	角膜穿孔
角膜色素环	K‐F环,角膜色素环
角膜透明	角膜透明
触及痉挛的乙状结肠	痉挛,乙状结肠触及
触及痉挛的降结肠	痉挛,降结肠触及
触及直肠内肿物	直肠触及,直肠肿块,直肠肿物
触及肝	肝触及
触及脾	脾触及
触觉减退	触觉减退,触觉障碍
触觉语颤减弱	触觉语颤减弱
触觉语颤增强	触觉语颤增强
触觉障碍	触觉障碍
言语不利	言语不利
言语不清	言语障碍,言语不清
言语兴奋	言语兴奋,兴奋
言语含糊不清	言语障碍,言语含糊不清
言语困难	言语困难
言语笨拙	言语笨拙
言语缓慢	言语缓慢
言语能力丧失	言语能力丧失,言语障碍
言语错乱	言语错乱,言语障碍
言语障碍	言语障碍
计算力下降	计算力下降,计算力减低
计算力减低	计算力减低
计算力损害	计算力损害
认知功能下降	认知功能下降
认知功能低下	认知功能低下
认知功能减退	认知功能减退,认知功能障碍
认知功能显著受损	认知功能受损
认知功能障碍	认知功能障碍
认知改变	认知改变
认知障碍	认知障碍,认知功能障碍
记忆丧失	记忆丧失,记忆缺失
记忆了下降	记忆下降
记忆了减退	记忆减退,记忆力减退
记忆减退	记忆减退,记忆力减退
记忆力下降	记忆力下降,记忆力减退
记忆力丧失	记忆力丧失
记忆力减退	记忆力减退
记忆力差	记忆力差
记忆力降低	记忆力减退,记忆力降低
记忆受损	记忆受损
记忆障碍	记忆障碍
讲话含糊不清	讲话含糊不清
语义性痴呆	语义性痴呆
语言减少	语言减少
语言发育差	语言发育差
语言困难	语言困难
语言增多	语言增多
语言能力下降	语言障碍,语言能力下降
语言能力障碍	语言障碍,语言能力障碍
语言表达障碍	语言障碍,语言表达障碍
语言重复	语言障碍,语言重复
语言障碍	语言障碍
语速变慢	语速变慢
语音迟钝	语音迟钝
语颤减弱	语颤减弱
语颤增强	语颤增强
误呛	误呛
诱发胎儿早产表现	胎儿表现,早产
诱发胎儿流产表现	流产,胎儿表现
说话带鼻音	说话带鼻音
说话费力	说话费力
谵妄	谵妄
谵妄状态	谵妄
豆渣样白带	白带豆渣样
象皮肿	象皮肿
贝尔征阳性	贝尔征,贝尔征阳性
负性心尖搏动	心尖搏动
负重能力下降	负重能力下降
败血症表现	败血症
贪食	贪食
贫血	贫血
贫血貌	贫血,贫血貌
贫血进行性加重	贫血
走路不稳	走路不稳
走路呈跨阈步态	跨阈步态
走路慢	走路慢
走路易跌倒	易跌倒,走路易跌倒,猝倒发作
起病相对隐匿	起病相对隐匿
起立后头晕	头晕
起立时头晕	头晕
超声心动图发现心脏赘生物	心脏赘生物
超声心动图可见三尖瓣反流	三尖瓣反流
超声心动图可见房间隔连续中断	房间隔连续中断
超声心动图检查可见左心室肥厚	左心室肥厚,心室肥厚
超声心动图示主动脉瓣瓣叶增厚	主动脉瓣增厚,瓣叶增厚
超声心动图示肺动脉呈条索样闭锁回声	肺动脉闭锁
超声心动图示舒张期主动脉反流	主动脉瓣反流
超声探及胸水	胸水
超声示残余尿量增加	尿量增多
超声见胆囊内结石	胆囊结石
超声见胆囊壁增厚	胆囊壁增厚
超声见胆囊壁水肿呈“双边征”	胆囊水肿,水肿
超重	超重
足下垂	足下垂
足内收受限	足内收受限
足内翻	足内翻
足坏疽经久不愈	经久不愈,坏疽
足外侧疼痛	足疼痛,足痛
足外侧缘感觉障碍	足障碍
足外翻	足外翻,足外展
足外翻外展	足外展,足外翻
足尖不能离地	足尖不能离地
足底剧烈疼痛	足底疼痛
足底感觉障碍	感觉障碍,足底感觉障碍,足底障碍
足底麻木	足底麻木
足心烧灼感	足心烧灼感
足心疼痛	足心疼痛
足拇趾背伸肌力下降	伸肌力下降,拇趾背下降,足下降
足掌部痛	足掌部痛
足背动脉搏动减弱	足背动脉搏动减弱
足背动脉搏动增强	足背动脉搏动增强
足背动脉搏动存在	足背动脉搏动存在
足背动脉搏动消失	足背动脉搏动消失
足背屈不能	足背屈不能
足背感觉障碍	足背障碍,感觉障碍,足背感觉障碍
足背肌腱囊性肿块	足背肿块,肌腱肿块
足背部感觉障碍	感觉障碍,足背部障碍,足背部感觉障碍
足趾依次出现苍白、青紫和潮红	足趾潮红,足趾青紫,足趾出现,足趾苍白
足趾剧烈烧灼样疼痛	足趾疼痛
足趾发凉	足趾发凉,发冷,发凉
足趾向下弯曲	足趾弯曲
足趾烧灼感	足趾烧灼感
足趾爪形姿势	足趾爪形姿势
足趾疼痛	足趾疼痛
足趾背屈不能	足趾背屈不能
足趾跖屈不能	足趾跖屈不能
足跖屈不能	足跖屈不能,足跖屈减弱
足跖屈肌力减弱	足跖屈减弱,足跖屈,肌力减弱
足跟垫增厚	足跟垫增厚
足跟痛	足跟痛,足痛,足部疼痛
足部伤口不易愈合	足部不易愈合,足部伤口不易愈合,伤口不易愈合
足部坏疽	足部坏疽,坏疽
足部感染	感染
足部感觉减退	足部感觉减退,感觉减退,感觉障碍,足部减退
足部振动觉减退	足部减退,振动觉,振动觉减退
足部溃疡	足部溃疡,足部破溃
足部畸形	足部畸形
足部皮肤发凉	发冷,发凉
足部皮肤干燥	皮肤弹性差,皮肤干枯,足部干燥,足部皮肤干燥,皮肤干燥
足部皮肤红肿	足部皮肤红肿,皮肤红肿,皮肤肿胀,足部红肿
足部皮肤红肿热	足部皮肤红肿热
足部破溃	足部破溃
足部肌力下降	肌力减弱,足部肌力下降,肌力下降,足部下降
足部胼胝	胼胝
足部触觉减退	触觉障碍,足部减退,触觉减退,足部触觉减退
足镯	足镯
足靴区皮肤营养性变化	足靴区变化,皮肤变化
趾甲变平	趾甲变平
趾甲增厚	趾甲增厚
趾甲松脆	趾甲松脆
趾甲粗糙	趾甲粗糙
趾甲缺乏光泽	趾甲缺乏光泽
趾甲脆薄易裂	趾甲脆薄易裂
跌倒	跌倒
跌倒发作	跌倒发作,跌倒
跑步易跌倒	跑步易跌倒,猝倒发作,易跌倒
跛行	跛行
跟腱反射减弱	跟腱反射减弱
跟腱反射时间延长	跟腱反射时间延长
跟腱反射消失	跟腱反射消失
跟腱挛缩	跟腱挛缩
跟腱缩短	跟腱缩短
跟膝胫试验阳性	跟膝胫试验阳性
跨越步态	跨越步态
踝关节伸直	踝关节伸直
踝关节周围肌无力	四肢无力,肌无力
踝关节周围肌萎缩	肌萎缩
踝关节痛	关节痛,踝关节痛
踝反射减弱	踝反射减弱
踝反射消失	踝反射消失
踝部水肿	踝部水肿
踝部肿胀	踝部肿胀
踝阵挛	踝阵挛
蹙眉皱额	蹙眉,皱额
蹲位困难	蹲位困难
蹲位站立困难	蹲位困难,蹲位站立困难,站立不稳
蹲位腹痛减轻	蹲位减轻,腹痛
蹲位起立困难	蹲位困难
蹲起困难	蹲起困难
蹼颈	蹼颈
躁动	躁动,烦躁不安,躁动不安
躁动不安	烦躁不安,躁动不安
躁狂	躁动不安,躁狂,烦躁不安
身体呈深鞠躬位	身体深鞠躬位
身体扭转	身体扭转
身体软弱	身体软弱
身材变矮	身材变矮,身材缩短
身材矮小	身材矮小,生长迟缓
身材缩短	身材缩短
身高低于同龄人	身高低于同龄人
身高增长过快	身高增长过快,身高增加迅速
身高落后	身高落后
躯体麻木	躯体麻木
躯干共济失调	躯干共济失调,共济失调
躯干性共济失调	共济失调
躯干扭转	躯干扭转
躯干皮疹	皮疹
躯干皮肤逐渐变黑	躯干变黑,皮肤发黑,皮肤变黑
躯干肌肉无力	四肢无力,肌肉无力,无力
躯干转动时疼痛加重	躯干转动,躯干加重,躯干疼痛
躯干高热但四肢不热	高热,躯干不热,发热,四肢不热
车祸后昏迷	昏厥,意识不清,昏迷
车祸后神志恍惚	恍惚,神志恍惚
转动身体时腹痛加重	腹痛
转移性右下腹痛	腹痛
转移性腹痛	腹痛
转颈无力	无力,转颈无力
软产道裂伤	软产道裂伤
软弱无力	软弱无力
软瘫	软瘫
软组织瘢痕	软组织瘢痕
软组织肿胀	软组织肿胀
软腭圆形囊肿	软腭圆形,软腭囊肿
软腭感觉障碍	感觉障碍,软腭障碍,软腭感觉障碍
软腭易出血肿块	软腭易出血肿块
软腭水肿	软腭水肿
软腭穿孔	软腭穿孔
软腭红肿	软腭红肿
软腭腺瘤	腺瘤
软腭萎缩	软腭萎缩
软腭麻痹	软腭麻痹
软骨毛发发育不全	软骨发育不全,软骨毛发发育不全
轻偏瘫	轻偏瘫
轻度嗜睡	嗜睡,意识不清
轻度活动后疲乏	疲惫,疲乏
轻度脂肪痢	脂肪泻,脂肪痢
轻度脾大	脾大
轻度腹泻	腹泻
轻度贫血	轻度贫血
轻度高血压	高血压
轻度黄疸	黄疸
轻微自主神经功能障碍	自主神经障碍,自主神经功能障碍
轻敲头部时头皮瘙痒	头皮瘙痒
较少出现自觉症状	症状出现,症状较少
输卵管增粗	输卵管增粗
输卵管缺如	输卵管缺如
输卵管肿块	输卵管肿块
输卵管胀大	输卵管胀大
输卵管轻度压痛	输卵管压痛
辨别觉丧失	辨别觉丧失
迁延性昏迷	意识不清,昏迷,昏厥
过度兴奋	兴奋
过敏性皮炎症状	过敏性皮炎
过早停经	停经
过期流产	过期流产
过清音	过清音
过高热	过高热
运动不耐症	运动不耐症,运动异常
运动协调功能减退	运动协调功能减退,运动异常
运动发育迟缓	运动发育迟缓,发育障碍
运动发育障碍	运动发育迟缓,运动发育障碍
运动后加重血尿	血尿
运动失调	运动异常,运动失调
运动异常	运动异常
运动性不安	不安
运动性失语	失语
运动性失语综合征	运动性失语综合征
运动时视力下降加重	视力差,运动加重,视力下降
运动症状	运动症状
运动神经元病症状	运动神经元病症状
运动神经异常	运动神经异常
运动耐量下降	运动耐量下降,运动耐力减退
运动耐量降低	运动耐力减退,运动耐量降低
运动诱发的心前区疼痛	运动疼痛,心前区痛,心前区疼痛,胸痛
运动迟滞	运动迟滞
运动迟缓	运动迟缓
运动障碍	运动异常,运动障碍
近中线肋缘下持续性钝痛	近中线肋缘下钝痛
近事健忘	健忘
近事记忆减退	记忆力减退,记忆减退
近期上呼吸道感染史	上呼吸道感染
近期链球菌感染史	链球菌感染
近端皮肤硬化	皮肤硬化
近端肌肉无力	肌肉无力,无力,四肢无力
近端肢体无力	四肢无力,乏力,肢体无力
近记忆力下降	近记忆力下降
进荤食后腹泻	腹泻
进行性体重下降	体重下降,体重减轻
进行性加重的头痛	头痛
进行性发音不清	发音不清
进行性吞咽困难	吞咽困难
进行性呼吸困难	呼吸困难,气促
进行性咀嚼无力	咀嚼无力,无力
进行性失语	失语
进行性小脑共济失调	小脑共济失调
进行性心力衰竭	心衰,心力衰竭
进行性心脏扩大	心脏扩大,心脏增大
进行性意识障碍	意识障碍,意识不清
进行性痛经	痛经
进行性眼外肌麻痹	进行性眼外肌麻痹
进行性眼肌麻痹	肌麻痹,眼肌麻痹
进行性肌张力增加	肌张力增高,肌张力增加
进行性肌无力	四肢无力,肌无力
进行性肾功能减退	肾功能减退
进行性认知功能障碍	认知功能障碍
进行性运动能力减退	运动减退
进行性近视	近视
进食后出现轻微腹痛	腹痛
进食后呕吐	进食后呕吐,呕吐
进食后啼哭	啼哭,进食后啼哭
进食后腹痛加重	腹痛
进食哽噎感	哽噎感,进食哽噎感
进食困难	进食困难
进食时颌下区疼痛	进食疼痛,颌下疼痛
进食时颌下肿胀感	进食肿胀感,颌下肿胀感
进食梗阻感	进食梗阻感
进食油腻食物腹部不适加重	食物不适,腹部不适,进食油腻食物
进食特殊食物腹泻加重	腹泻
进餐后胸痛	胸痛
远期记忆减退	记忆力减退,记忆减退
远端肌萎缩	肌萎缩
远视力差	远视力差
连续ACTH兴奋试验无皮质醇反应	兴奋
连续ACTH兴奋试验有皮质醇反应	兴奋
连续咀嚼无力	无力,咀嚼无力
连续性肢端皮炎	皮炎
迟缓性瘫痪	瘫,瘫痪
迷走神经麻痹	迷走神经麻痹
迷路不能回家	迷路不能回家
逆行性遗忘	遗忘
透光试验阳性	透光试验阳性
通气不足	通气不足
遇冷出现血红蛋白尿	血红蛋白尿
遗传性共济失调	遗传性共济失调
遗尿	遗尿
遗忘	遗忘
遗留手足徐动症	遗留手足徐动症
遗留舞蹈症	遗留舞蹈症
遗精	遗精
酱油样尿	尿酱油样
酱油色尿	血尿,尿色深
酱油色血尿	血尿
酸中毒	酸中毒
酸中毒症状	酸中毒
酸碱平衡紊乱	酸碱平衡紊乱
醉酒后发热	发热
醉酒步态	醉酒
里急后重	里急后重
里急后重感	里急后重,里急后重感
重听	重听
重复语言	语言障碍
重度贫血	贫血,重度贫血
重症肌无力	重症肌无力
针尖样瞳孔	瞳孔针尖样
钠摄入过多	钠摄入过多
钡剂激惹征	易激惹,激惹
钡餐显示食管末端狭窄呈鸟嘴状	食管狭窄
钡餐检查：吞钡后显示食管被动性扩张	食管扩张
钡餐见假憩室形成	憩室形成
铁锈色痰	痰铁锈色
铜蓝蛋白降低	铜蓝蛋白降低
银屑病损害	银屑病,银屑病损害
锁孔状珠黄色花斑样病损坏	锁孔状珠黄色花斑样病损坏
锁孔状白色花斑样病损坏	锁孔状白色花斑样病损坏
锁骨上下窝闻及血管杂音	锁骨上下窝闻及血管杂音
锁骨上动脉搏动增强	动脉搏动增强,锁骨上动脉搏动增强
锁骨上淋巴结肿大	锁骨上淋巴结肿大,淋巴结肿大
锁骨上窝凹陷	锁骨上窝凹陷
锁骨上窝可闻及血管杂音	锁骨上窝闻及血管杂音
锁骨上闻及连续性血管杂音	血管杂音
锁骨下窝可闻及血管杂音	锁骨闻及血管杂音
锤状趾畸形	锤状趾畸形,锤状趾
锤骨柄向上移位	锤骨柄向上移位
锤骨柄周围血管放射状扩张	锤骨柄扩张,血管扩张
锤骨柄浮雕状	锤骨柄浮雕状
锤骨短突外突	锤骨短突外突
锤骨短突白垩色	锤骨短突白垩色
锥体外系反应	锥体外系反应
锥体外系改变	锥体外系改变
锥体束受损体征	体征受损,锥体束受损体征,锥体束受损
锥体束征阳性	锥体束征阳性
锥体束症状	锥体束症状
镜面舌	镜面舌
长吸气	吸气长
长头畸形	长头畸形
长期低热	发热,低热
长期便秘	便秘
长期动物性食物摄入不足	食物摄入不足
长期反复发热	发热
长期发热	发热
长期头痛	头痛
长期腹泻	腹泻
长骨局部肿胀	长骨肿胀
长骨髓腔增宽	长骨髓腔增宽
门板样跌倒	跌倒
门静脉高压	门静脉高压
闪光	闪光
闪光感	闪光感
闭孔内肌试验（obturator征）阳性	obturator征,闭孔内肌试验阳性
闭目难立征阳性	闭目难立征阳性
闭目难立（Romberg）征阳性	闭目难立,肌红蛋白阳性
闭眼无力	无力,闭眼无力
闭经	闭经,停经
闭锁综合征	闭锁综合征
间接对光反射消失	对光反射消失,间接对光反射消失
间断上腹部疼痛	上腹疼,腹痛,上腹痛,上腹疼痛
间断下腹痛	下腹痛,腹痛
间断性头晕	头晕
间断性头痛	头痛
间断性头胀	头胀
间断腹泻	腹泻
间歇性下颌运动障碍	运动异常,运动障碍
间歇性便后出鲜血	出鲜血
间歇性发热	发热
间歇性多尿	多尿,尿频
间歇性尿频	尿频
间歇性心搏脱漏	心搏脱漏
间歇性肢端感觉异常	肢端感觉异常
间歇性肢端疼痛	肢端疼痛
间歇性肢端血管痉挛	血管痉挛
间歇性跛行	跛行
间歇性黄疸	黄疸
间歇无痛肉眼血尿	肉眼血尿,血尿
间歇热	间歇热
间歇跛行	跛行
间歇高血压	高血压
间脑综合征	间脑综合征
间质性角膜炎	角膜炎
阅读困难	阅读困难
阑尾异位点固定压痛	阑尾固定压痛,阑尾异位点固定压痛
阳痿	阳痿
阴唇粘连	阴唇粘连
阴唇肿物	阴唇肿物,外阴肿物
阴唇阴蒂疣状突起	阴蒂疣,阴唇突起,外阴肿物,阴唇疣,阴蒂突起
阴囊下坠	阴囊下坠
阴囊下坠感	阴囊下坠感
阴囊不适	阴囊不适
阴囊内肿块	阴囊肿块,阴囊肿胀
阴囊内肿块穿刺液棕色	穿刺棕色,阴囊肿胀,穿刺肿块,阴囊肿块,阴囊棕色
阴囊内肿块穿刺见清亮淡黄色液体	穿刺黄色液体,阴囊肿胀,穿刺肿块,阴囊肿块,阴囊黄色液体
阴囊内肿块透光试验阳性	阴囊阳性,肿块透光试验阳性
阴囊发育不良	阴囊发育不良,发育不良,发育障碍
阴囊囊性肿块	阴囊肿块,阴囊肿胀
阴囊坠痛	阴囊坠痛,阴囊疼痛
阴囊坠胀感	阴囊坠胀感
阴囊坠胀痛	阴囊疼痛,阴囊坠胀
阴囊托高试验阳性	阴囊托高试验阳性
阴囊扪及束状条索物	阴囊扪及
阴囊扪及蚯蚓状肿物	阴囊肿物,阴囊扪及,阴囊肿胀
阴囊水肿	阴囊肿胀,水肿,阴囊水肿
阴囊淋巴结曲张	阴囊淋巴结曲张
阴囊牵扯感	阴囊牵扯感
阴囊牵拉痛	阴囊牵拉痛
阴囊疼痛	阴囊疼痛
阴囊皮肤发热	发热,皮肤发热
阴囊皮肤发红	阴囊发红,皮肤发红,皮肤红,阴囊皮肤发红
阴囊皮肤呈红黑色	皮肤红黑色,阴囊红黑色
阴囊皮肤疼痛	阴囊疼痛,阴囊皮肤疼痛,皮肤疼痛,皮肤痛
阴囊皮肤红肿	皮肤红肿,皮肤肿胀,阴囊红肿,阴囊肿胀,阴囊皮肤红肿
阴囊空虚	阴囊空虚
阴囊窦道形成	阴囊窦道形成,阴囊形成,窦道形成
阴囊红肿	阴囊红肿,阴囊肿胀
阴囊红肿触痛	阴囊红肿,阴囊肿胀,阴囊疼痛
阴囊肿块位于睾丸上方	阴囊肿胀,阴囊肿块
阴囊肿痛	阴囊疼痛,阴囊肿痛,阴囊肿胀
阴囊肿胀	阴囊肿胀
阴囊胀大	阴囊胀大
阴囊胀痛	阴囊疼痛,阴囊胀痛
阴囊膨隆	阴囊膨隆
阴囊部下坠感	阴囊部下坠感
阴囊部位坠胀不适	阴囊部坠胀,阴囊部不适
阴囊部肿胀不适	阴囊肿胀,阴囊部不适
阴囊部血肿	血肿
阴囊钝痛	阴囊钝痛
阴囊隐痛	阴囊隐痛,阴囊疼痛
阴毛减少	阴毛减少
阴毛早现	阴毛早现
阴毛稀少	阴毛稀少
阴毛稀疏	阴毛稀疏
阴毛脱落	阴毛脱落
阴茎体短小	阴茎短小,阴茎小
阴茎内陷	阴茎内陷
阴茎头部溃疡	阴茎头部溃疡
阴茎头部疣状红斑	阴茎头部红斑,阴茎头部疣
阴茎头部类丘疹	阴茎头部红斑,丘疹,皮疹
阴茎系带缺如	阴茎缺如
阴茎缩小	阴茎缩小,阴茎缩短
阴茎肿胀	阴茎肿胀
阴蒂分裂	阴蒂分裂
阴蒂肥大	阴蒂肥大
阴道不规则出血	阴道出血
阴道不规则流血	阴道出血,阴道流血
阴道不适	阴道不适
阴道充血	阴道充血
阴道内有尿样液体流出	阴道内液体流出
阴道内烧灼感	阴道内烧灼感
阴道内肿痛	阴道内肿痛
阴道出血	阴道出血
阴道分泌物假丝酵母菌的芽生孢子和假菌丝	假丝酵母菌
阴道分泌物减少	阴道分泌物减少
阴道分泌物呈泡沫状	阴道分泌物泡沫状
阴道分泌物呈灰白色	阴道分泌物灰白色
阴道分泌物呈稀薄脓性	阴道分泌物稀薄
阴道分泌物呈黏液脓性	阴道分泌物黏液
阴道分泌物增加	阴道分泌物增加,阴道分泌物增多,阴道分泌物异常
阴道分泌物增多	阴道分泌物异常,阴道分泌物增加,阴道分泌物增多
阴道分泌物淡黄色	阴道分泌物异常,阴道分泌物淡黄色
阴道分泌物滴虫阳性	阴道分泌物阳性
阴道分泌物灰黄色	阴道分泌物灰黄色,阴道分泌物异常
阴道分泌物稀薄匀质	阴道分泌物稀薄
阴道分泌物线索细胞阳性	阴道分泌物阳性,线索细胞阳性
阴道分泌物黄白色	阴道分泌物黄白色,阴道分泌物异常
阴道分泌物黄绿色	阴道分泌物黄绿色,阴道分泌物异常
阴道前后壁膨出	阴道膨出
阴道前壁紫蓝色结节	前壁结节,阴道结节
阴道口宫颈疣状突起	阴道口突起,宫颈突起,阴道口疣,宫颈疣
阴道口挛缩狭窄	阴道口挛缩,阴道口狭窄
阴道口有肿物脱出	阴道脱出肿物,阴道口脱出,阴道口肿物
阴道口红肿疼痛	阴道口疼痛,阴道口红肿
阴道口黏膜充血水肿	阴道口水肿,黏膜水肿,黏膜充血,阴道口充血
阴道后壁黏膜呈球状物膨出	黏膜膨出,黏膜球状物,阴道后壁膨出
阴道后穹窿小结节	阴道后穹窿小结节,阴道结节
阴道后穹窿有羊水自宫颈口流出	羊水流出,宫颈口流出,阴道流出
阴道后穹窿紫蓝色斑点	阴道斑点
阴道后穹窿紫蓝色结节	阴道结节
阴道后穹窿触痛	后穹窿触痛,阴道后穹窿触痛,阴道压痛
阴道后穹窿饱满	阴道饱满,阴道后穹窿饱满
阴道壁变硬	阴道壁变硬
阴道壁变薄	阴道壁变薄
阴道壁结节	阴道壁结节
阴道壁萎缩	阴道壁萎缩
阴道壁赘生物	阴道壁赘生物
阴道大量脓性分泌物	分泌物大量
阴道局部变硬	阴道质硬
阴道干燥	阴道干燥
阴道恶臭分泌物	阴道恶臭分泌物,阴道恶臭,分泌物恶臭
阴道排出物中见到水泡状组织	阴道排出,组织排出
阴道排出血凝块	阴道排出
阴道排出黄色水样液体	阴道排出,阴道黄色
阴道排恶臭液	阴道恶臭
阴道排液	阴道排液
阴道排液呈米泔样腥臭味	阴道排液,阴道腥臭味
阴道排液增多	阴道增多,阴道排液
阴道接触性出血	阴道出血
阴道松弛	阴道松弛
阴道检查囊性肿块压痛	阴道压痛,阴道肿块
阴道检查囊性肿块向后穹窿突出	阴道突出,阴道肿块
阴道水样分泌物	阴道分泌物异常,阴道水样分泌物
阴道水肿	阴道水肿
阴道流液	阴道流液
阴道流血	阴道流血,阴道出血
阴道溃疡	阴道溃疡
阴道溢液	溢液,阴道溢液
阴道灼热感	阴道灼热感
阴道狭窄	阴道狭窄
阴道疼痛	阴道疼痛,阴道痛
阴道痛	阴道痛,阴道疼痛
阴道瘙痒	阴道瘙痒
阴道积脓	阴道积脓
阴道粘膜糜烂	阴道糜烂,粘膜糜烂,阴道粘膜糜烂
阴道糜烂	阴道糜烂
阴道脓性分泌物增多	分泌物增多,阴道分泌物增多,阴道分泌物异常,阴道分泌物增加
阴道脓样分泌物	阴道脓样分泌物,分泌物脓样,阴道脓样
阴道脓血性恶臭分泌物	分泌物恶臭,阴道恶臭分泌物,阴道恶臭
阴道膨出	阴道膨出
阴道萎缩	阴道萎缩
阴道萎缩性改变	阴道改变
阴道血样脓性排液	阴道血样,阴道排液
阴道闭锁	阴道闭锁
阴道黏膜充血	阴道黏膜充血,阴道充血,黏膜充血
阴道黏膜出血点	阴道出血点,阴道黏膜出血点,黏膜出血点
阴道黏膜增厚角化	阴道角化,阴道增厚,黏膜增厚,黏膜角化
阴道黏膜红肿	阴道黏膜红肿,阴道红肿,黏膜红肿
阴道黏膜附有白色块状物	阴道块状物,阴道白色,黏膜白色,黏膜块状物
阵发右上腹绞痛	腹痛
阵发性剧烈右上腹部绞痛	腹痛,腹部绞痛
阵发性剧烈头痛	头痛
阵发性剧烈腹痛	腹痛
阵发性呼吸困难	呼吸困难,气促
阵发性哭闹	哭闹
阵发性干咳	干咳,咳嗽
阵发性强烈痉挛	痉挛
阵发性心房颤动	心房颤动
阵发性缺氧	缺氧
阵发性肌痛	肌痛
阵发性腹痛	腹痛
阵发性腹部绞痛	腹部绞痛,腹痛
阵发性腹部胀痛	腹痛,腹部胀痛
阵发性舌部剧痛	舌痛
阵发性面颊痛	面颊痛
阵发性高热	发热,高热
阵发性高血压	高血压
阵发腹痛	腹痛
阶段性分离性感觉障碍	分离性感觉障碍
阻塞性通气功能障碍	通气功能障碍
阿-罗瞳孔	阿-罗瞳孔
附件区光滑包块	腹包块,附件包块,附件区包块
附件区压痛	附件区压痛
附件区扪及与子宫相连的囊性偏实不活动包块	附件区不活动,子宫扪及,附件区扪及,子宫包块,腹包块,附件包块
附件压痛	附件压痛
附件触痛	附件触痛
附睾压痛	附睾压痛,附睾疼痛
附睾增厚	附睾增厚
附睾炎	附睾炎
附睾疼痛	附睾疼痛
附睾硬结	附睾硬结
附睾肿大	附睾肿大
附睾肿痛	附睾疼痛,附睾肿痛
限制性呼吸功能障碍	呼吸功能障碍
限制性心肌病	心肌病,心肌病变
限制性通气功能障碍	通气功能障碍
陶土样大便	大便陶土样
陶土色大便	大便陶土色
陶瑟征阳性	陶瑟征,陶瑟征阳性
陷入昏睡状态	昏睡
隆起皮肤红肿热痛	皮肤隆起,皮肤疼痛,皮肤痛
随体位改变的心脏杂音	体位改变,心脏杂音
随意运动时不自主运动加重	运动加重,不自主运动
随机尿蛋白（＋）	尿蛋白阳性,尿蛋白,蛋白尿阳性
随机蛋白尿≥（+++）	蛋白尿
隐囊隐痛	隐囊
隐睾	隐睾病
难以理解的言语	言语难以
难治性哮喘	哮喘
雷诺现象	雷诺现象
雾视	雾视
需站立片刻并缓慢活动一会儿才能迈步	活动才能迈步,活动缓慢,活动站立片刻
震颤麻痹综合征	震颤麻痹综合征
霍纳综合征	霍纳综合征
露齿时口角歪向健侧	口角歪向健侧
青光眼	青光眼
青春期发育延迟	发育延迟,青春期延迟,青春期发育延迟
青春期延迟	青春期延迟
青紫	青紫
静坐不能	静坐不能
静息后初次运动较重	运动较重
静息心绞痛	心绞痛
静止时手抖	手抖
静立后不能起步	不能起步
静脉功能不全	静脉功能不全
静脉部位压痛	静脉部位压痛,部位压痛,静脉压痛
静脉部位条形红肿	静脉红肿,部位条形,部位红肿,静脉条形
非凹陷性水肿	水肿
非对称性下肢大关节痛	大关节痛,关节痛
非少尿型急性肾损伤	急性肾损伤
非月经期出现少量阴道出血	阴道出血
非甾体抗炎药能迅速缓解症状	症状缓解
非结合胆红素升高	非结合胆红素升高
面具脸	面具脸
面孔失认	面孔失认,失认
面容刻板	面容刻板
面容幼稚	面容幼稚
面容瘦长	面容瘦长
面容硕圆	面容硕圆
面瘫	面瘫
面神经叩击征阳性	面神经叩击征,面神经叩击征阳性
面神经叩击征（ Chvostek征）阳性	面神经叩击征,面神经叩击征阳性
面神经瘫痪	瘫,瘫痪
面肌不受累	面肌不受累
面肌感觉障碍	面肌障碍,感觉障碍,面肌感觉障碍
面肌抽搐	面肌抽搐
面肌无力	无力,面肌无力
面肌无痛性强直	面肌强直
面肌痉挛	面肌痉挛
面肌瘫痪	瘫痪,瘫
面肌萎缩	面肌萎缩
面肌阵发性抽动	面肌抽搐
面色发灰	面色发灰
面色发白	皮肤苍白,面色发白
面色发红	面色发红
面色发绀	发绀,面色发绀
面色憔悴	面色憔悴
面色晦暗	面色晦暗
面色潮红	面色潮红
面色灰白	皮肤苍白,面色灰白
面色苍白	面色苍白,皮肤苍白
面色苍黄	面色苍黄
面色青灰	面色青灰
面色青紫	面色青紫
面部不对称变形	面部不对称,面部变形
面部充血	面部充血
面部口腔卫生差	面部差,口腔卫生差,面部口腔卫生差
面部怪异表情	面部怪异,表情怪异,面部怪异表情
面部感觉减退	感觉障碍,感觉减退,面部减退,面部感觉减退
面部感觉异常	面部感觉异常
面部感觉迟钝	感觉障碍,面部感觉迟钝,感觉迟钝,面部迟钝
面部无汗	无汗,面部无汗
面部毁容	毁容,面部毁容
面部溃疡	面部溃疡
面部潮红	面部潮红
面部畸形	面部畸形
面部疼痛	面部疼痛
面部病侧无汗	面部无汗,无汗
面部痛性抽搐	面肌抽搐,抽搐
面部白斑	面部斑,面部白斑
面部白色蛔虫斑	面部斑,面部白色,面部蛔虫斑
面部皮疹	皮疹
面部皮肤菲薄	面部皮肤菲薄
面部皮肤萎缩	面部皮肤萎缩
面部皮脂腺瘤	皮脂腺瘤,面部皮脂腺瘤
面部粗糙	面部粗糙
面部红斑	面部红斑,面部斑,红斑
面部红葡萄酒色扁平血管痣	血管扁平,面部扁平,血管痣
面部肌肉抽动	面肌抽搐,肌肉抽动,面部肌肉抽动
面部肌肉无力	无力,四肢无力,肌肉无力
面部肌肉痉挛	肌肉痉挛,痉挛
面部肿胀	面部肿胀
面部胀满感	面部胀满感
面部色素沉着	面部色素沉着
面部表情少	面部表情少,面部少,表情少
面部隆起	面部隆起
面部青紫	面部青紫
面部骨骼萎缩	面部萎缩,骨骼萎缩,面部骨骼萎缩
面部麻木	面部麻木
面部麻木感	面部麻木,面部麻木感
面部麻木或疼痛	面部疼痛,面部麻木
面部麻痹	面部麻痹
面颈部肿胀	颈肿块,面颈部肿胀,颈部肿胀,面部肿胀
面颈部色黄	面颈部色黄
面颊不对称	面颊不对称
面颊暗红	面颊暗红
面颊部疼痛	面颊部疼痛,面颊痛
面颊部胀痛	面颊部胀痛,面颊痛
面颊部隆起	面颊部隆起
面颊部麻木感	面颊部麻木感
面颊隆起	面颊隆起
鞍区感觉异常	鞍区感觉异常
鞍鼻	鞍鼻
音色改变	音色改变
音质改变	音质改变
顽固性便秘	便秘
顽固性呃逆	呃逆
顽固性呃逆/呕吐	呃逆,呕吐
顽固性奇痒	奇痒
顽固性尿痛	尿痛
顽固性尿频	尿频
顽固性消化性溃疡	消化性溃疡
顽固性血尿	血尿
颅内出血	脑出血,颅内出血
颅内压升高	颅内压升高
颅内压升高症状	颅内压升高
颅内压增高	颅内压增高
颅内压增高症状	颅内压增高
颅内压增高症状明显	颅内压增高,症状明显
颅内肿物	颅内肿物
颅周肌肉压痛	颅周压痛,肌肉压痛,颅周肌肉压痛,肌痛
颅底头痛	颅底头痛,头痛
颅缝分离	颅缝分离
颅缝增宽	颅缝增宽
颅缝开裂	颅缝开裂
颅缝裂开	颅缝裂开,颅缝开裂
颅脑CT示弥漫性轴索损伤	弥漫性轴索损伤
颅脑CT示脑萎缩	脑萎缩
颅骨病理性骨折	颅骨骨折
颅骨破坏	颅骨破坏
颅骨缺损	颅骨缺损
颅骨肿块	颅骨肿块
颅骨软化	骨软化
颅骨骨髓炎病史	骨髓炎
颈上深淋巴结肿大	颈上肿大,颈上深,淋巴结肿大,淋巴结深
颈上深部淋巴结不活动	颈上不活动,淋巴结不活动
颈上深部淋巴结无痛性肿大	淋巴结肿大,颈上肿大
颈上深部淋巴结活动度差	颈上活动度差,淋巴结活动度差
颈上深部淋巴结质硬	颈上质硬,淋巴结质硬
颈下部背侧肌肉及其软组织持续性疼痛	肌肉下部,颈下部,颈痛,软组织下部,软组织疼痛,肌痛
颈侧区无痛结节	颈侧区结节,颈侧区无痛
颈侧区质硬结节	颈侧区质硬结节
颈内动脉缺血表现	颈内动脉缺血,动脉表现,颈内表现,动脉缺血,颈内缺血
颈前上方实性包块	颈部包块
颈前疼痛	颈前疼痛
颈前疼痛向患侧耳颞处放射	耳颞处放射,颈前放射,颈前疼痛,耳颞处疼痛
颈前部疼痛	颈前部疼痛
颈前部肿块	颈前部肿块
颈动脉怒张	颈动脉怒张
颈动脉搏动减弱	颈动脉搏动减弱
颈动脉搏动增强	动脉搏动增强,颈动脉搏动增强,颈增强
颈动脉搏动延迟	动脉搏动延迟,颈延迟,颈动脉搏动延迟
颈动脉搏动消失	颈动脉搏动消失,猝死,颈消失,动脉搏动消失
颈动脉血管杂音	颈动脉血管杂音,血管杂音,颈动脉杂音
颈后三角区囊性肿块	颈后肿块
颈后淋巴结肿大	淋巴结肿大,颈后肿大,颈后淋巴结肿大
颈后疼痛	颈后疼痛
颈后皮肤增厚	颈后皮肤增厚,皮肤增厚
颈围粗	颈围粗
颈强直	颈项抵抗,颈部僵硬,颈强
颈性眩晕	颈性眩晕
颈扭转实验阳性	颈扭转实验阳性
颈枕部强直	颈部僵硬,颈强直,枕部强直,颈枕部强直,颈项抵抗
颈枕部疼痛	颈痛,枕部疼痛,枕部痛,颈枕部疼痛
颈椎痛	颈椎痛
颈段气管狭窄	颈段狭窄,颈段气管狭窄,气管狭窄
颈消瘦	颈消瘦
颈疼痛	颈疼痛,颈痛
颈痛	颈痛
颈短	颈短
颈短粗	颈短粗,颈短
颈肌僵硬	颈肌僵硬
颈肌痉挛	痉挛,颈肌痉挛
颈肩痛	颈肩痛
颈肩痛向上肢放射	肢放射,颈肩痛
颈背强直	颈背强直
颈背痛	颈背痛
颈胸部红斑	颈红斑,胸部红斑
颈软	颈软
颈部不适	颈部不适
颈部假性僵直	颈部僵直,颈部僵硬
颈部僵硬	颈部僵硬
颈部出现结节	颈部结节,颈部出现
颈部前屈受限	颈部前屈受限
颈部包块	颈部包块
颈部压痛	颈部压痛,颈痛
颈部发硬	颈部发硬,颈部僵硬
颈部可闻及血管杂音	颈部闻及血管杂音
颈部哮鸣音	哮鸣音,喘鸣音,颈部哮鸣音
颈部囊性圆形肿物	颈部肿物,颈部圆形,颈肿块
颈部囊性肿物	颈肿块,颈部肿物
颈部增粗	颈肿块,颈部增粗
颈部强直	颈项抵抗,颈部僵硬,颈部强直,颈强直
颈部强迫体位	颈部强迫体位
颈部抵抗	颈部抵抗
颈部放射痛	颈部放射痛,颈痛
颈部旋转时疼痛加重	颈部疼痛,颈部旋转,颈痛,颈部加重
颈部无痛性肿块	颈肿块,颈部肿块
颈部明显搏动	颈部搏动,颈部明显
颈部杂音	颈部杂音
颈部活动受限	颈部活动受限
颈部淋巴结压痛	颈部压痛,淋巴结疼痛,淋巴结压痛,颈部淋巴结压痛,颈痛
颈部淋巴结肿大	颈肿块,淋巴结肿大,颈部肿大,颈部淋巴结肿大
颈部疼痛	颈痛,颈部疼痛
颈部皮肤破溃	皮肤破溃,颈部皮肤破溃
颈部粗短	颈部粗短
颈部肌无力	肌无力,颈部肌无力,四肢无力
颈部肌肉压痛	肌肉压痛,颈部肌肉压痛,肌痛,颈痛,颈部压痛
颈部肌肉紧张	肌肉紧张,颈部肌肉紧张,颈部紧张
颈部肌肉群不自主收缩	颈部肌肉群不自主收缩,颈部不自主收缩,肌肉群不自主收缩
颈部肿块	颈肿块,颈部肿块
颈部肿块透光试验阳性	肿块透光试验阳性,颈部肿块透光试验阳性,颈部阳性
颈部肿大	颈肿块,颈部肿大
颈部肿物	颈肿块,颈部肿物
颈部肿物压痛阳性	颈部阳性,颈肿块,颈部压痛,颈痛,颈部肿物
颈部肿胀	颈部肿胀,颈肿块
颈部胀感	颈部胀感
颈部胸锁乳突肌挛缩	颈部挛缩,胸锁乳突肌萎缩,颈部胸锁乳突肌挛缩
颈部血管杂音	血管杂音,颈部杂音,颈部血管杂音
颈部触及单个淋巴结	淋巴结触及,颈部触及,淋巴结单个,颈部单个
颈部超声示甲状腺结节	甲状腺结节,颈部结节
颈阔肌抽搐	颈阔肌抽搐
颈静脉充盈	颈静脉充盈
颈静脉充盈不全	颈静脉充盈不全
颈静脉出现巨大a波	颈静脉巨大a波,颈静脉出现
颈静脉可见巨大a波	颈静脉可见巨大a波
颈静脉孔综合征	颈静脉孔综合征
颈静脉怒张	颈静脉充盈,颈静脉怒张
颈静脉扩张	颈静脉充盈,颈静脉扩张
颈静脉搏动a波消失	颈静脉搏动a波消失
颈静脉搏动增强	颈静脉搏动增强
颈项强直	颈强直,颈项抵抗,颈项强直,颈部僵硬
颈项抵抗	颈项抵抗
颈项板紧	颈项板紧
颈项痛	颈项痛,颈痛
颈项部活动受限	颈项部活动受限
颈项部肌肉紧张	颈项部紧张,肌肉紧张,颈项部肌肉紧张
颊粘膜疱疹	疱疹,颊粘膜疱疹
颊部盘状红斑	颊部红斑,颊部盘状
颊部红斑	颊部红斑
颊部蝶形分布的红斑	颊部红斑
颊黏膜水疱	水疱
颌下区不适	颌下不适
颌下区反复肿痛史	颌下肿痛
颌下区疼痛	颌下疼痛
颌下区红肿	颌下红肿
颌下区肿大	颌下肿大
颌下区胀痛	颌下胀痛
颌下淋巴结肿大	颌下淋巴结肿大
颌下淋巴结肿大伴压痛	颌下淋巴结肿大
颌下腺压痛	颌下腺压痛
颌下腺导管口红肿	颌下腺红肿
颌下腺稍硬	颌下腺稍硬
颌下腺肿大	颌下腺肿大
颌下腺质稍硬	颌下腺稍硬
颌面发育畸形	发育畸形,颌面发育畸形
颏部发育不良	颏部发育不良,发育障碍,发育不良
频泻	频泻
频繁出现进食后腹痛	腹痛
频繁呕吐	呕吐
颜面、皮肤潮红	颜面潮红,皮肤红,皮肤潮红
颜面发绀	颜面发绀
颜面小	颜面小
颜面感觉分离	颜面感觉分离,颜面分离,感觉分离
颜面水肿	颜面水肿,面部肿胀
颜面潮红	颜面潮红
颜面皮肤逐渐变黑	颜面变黑,皮肤变黑,皮肤发黑
颜面轻度水肿	颜面水肿,面部肿胀
额外心音	心音额外
额眶部浅静脉扩张	额眶部浅静脉扩张,浅静脉扩张,额眶部扩张
额纹消失	额纹消失
额肌收缩	额肌收缩
额部头痛	头痛,额部头痛
额部感觉异常	额部感觉异常
额部疼痛	额部疼痛
额部皮肤麻木	额部皮肤麻木,皮肤麻木,额部麻木,皮肤麻
额部胀痛	额部疼痛,额部胀痛
额部隆起	额部隆起
额颞部撕裂痛	额颞部撕裂,额部疼痛,额颞部疼痛
额颞部疼痛	额颞部疼痛,额部疼痛
额颞部胀痛	额颞部胀痛,额部疼痛
颞侧偏盲	偏盲,颞侧偏盲
颞侧头痛	颞侧头痛,头痛
颞浅动脉压痛	颞浅动脉压痛
颞浅动脉增粗变硬	颞浅动脉增粗,颞浅动脉变硬
颞浅动脉结节状增粗变硬伴压痛	颞浅动脉增粗,颞浅动脉压痛,颞浅动脉变硬,颞浅动脉结节状
颞部隆起	颞部隆起
颞颌关节疼痛加重	关节痛,关节疼痛,颞颌加重
颞颌关节痛	关节痛,颞颌关节痛
颞颌部无力	无力,颞颌部无力
颧部皮肤萎缩	颧部萎缩,颧部皮肤萎缩,皮肤萎缩
颧骨隆起	颧骨隆起
颧骨高突	颧骨高突,颧骨隆起
风团	风团
风团样丘疹	丘疹,风团,皮疹
风湿热病史	风湿热
风湿结节	风湿
飞蚊症	飞蚊症
食欲下降	食欲下降,厌食,食欲减退
食欲不振	食欲减退,食欲不振
食欲亢进	食欲亢进
食欲低下	厌食,食欲低下,食欲减退
食欲减退	厌食,食欲减退
食欲增加	食欲增加
食欲差	食欲减退,厌食,食欲差
食欲缺乏	食欲缺乏,食欲减退
食物反流	食物反流
食物易滞留患侧齿龈	食物易滞留患侧齿龈
食管内异物感	食管内异物
食管出血	食管出血
食管功能障碍	食管功能障碍
食管吞钡检查见食管受压	食管受压
食管呈串珠状或螺旋状狭窄	食管狭窄
食管扩大	食管扩大
食管胃底静脉曲张	静脉曲张
食管静脉曲张	食管静脉曲张
食管黏膜溃烂	黏膜溃烂,食管黏膜溃烂,食管溃烂
食管黏膜灼伤	食管灼伤,黏膜灼伤,食管黏膜灼伤
食道异物感	异物感,食道异物感
食道疼痛	食道疼痛
食量下降	食量下降
食量大	食量大
餐后30-60分钟呕吐	呕吐
餐后上腹痛	上腹痛,腹痛
餐后血糖升高为主	餐后血糖升高
餐后血糖水平升高	餐后血糖升高
饥饿	饥饿
饥饿感	饥饿感
饥饿时腹痛加重	腹痛,饥饿
饥饿痛	饥饿痛
饮水呛咳	饮水呛咳,呛咳
饮酒后淋巴结疼痛	淋巴结疼痛
饮食不节诱发腹痛	腹痛
饮食改变	饮食改变
饱食后胸痛	饱食后胸痛,胸痛
饶舌	饶舌
香肠指	香肠指
马蹄肾	马蹄肾
马鞍回避	马鞍回避
驼背	驼背
驼背畸形	驼背畸形,驼背
骚动不安	骚动不安
骨关节挛缩	骨关节挛缩
骨关节浸润	骨关节浸润
骨关节痛	骨痛,骨关节痛
骨关节肌肉疼痛	肌痛,肌肉疼痛,骨痛,肌肉痛,骨关节肌肉疼痛
骨压痛	骨压痛
骨囊肿	骨囊肿
骨密度降低	骨密度降低,骨密度低
骨局部压痛	骨压痛
骨局部肿块	骨肿块
骨局部肿胀	骨肿胀
骨性外耳道内段后上壁红肿	外耳道肿胀
骨折	骨折
骨折近折端向背侧移位	骨折
骨折近端向掌侧移位	骨折
骨折远折端向掌侧、桡侧移位	骨折
骨折远端向桡侧、背侧移位	骨折
骨折部压痛明显	骨折
骨折部疼痛	骨折
骨摩擦音	骨摩擦音,骨擦音
骨擦感	骨擦感
骨擦音	骨擦音
骨擦音(感)	骨擦音
骨活检异常	骨异常
骨畸形	骨畸形
骨痛	骨痛
骨盆倾斜	骨盆倾斜
骨盆向两侧上下摆动	骨盆摆动
骨盆带肌肉萎缩	肌肉萎缩,肌萎缩,骨盆带萎缩,骨盆带肌肉萎缩
骨突出部肿物	骨突出部肿物
骨缝分开	骨缝分开
骨肿痛	骨痛,骨肿痛
骨质增厚粗糙	骨质粗糙,骨质增厚
骨质疏松	骨质疏松
骨质隆起	骨质隆起
骨赘形成	骨赘形成,骨赘
骨间肌萎缩	肌萎缩,骨间肌萎缩
骨骼变大	骨骼变大
骨骼畸形	骨畸形,骨骼畸形
骨骼疼痛	骨骼疼痛,骨痛
骨骼病变	骨骼病变
骨骼破坏	骨骼破坏
骨骼肌强直性收缩	骨骼肌收缩
骨骼肌持续性收缩	骨骼肌收缩
骨骼肌用力收缩后放松困难	骨骼肌收缩
骨骼胀痛	骨痛,骨骼胀痛
骨骼触痛	骨痛,骨骼触痛
骨髓中红系增生明显	骨髓增生
骨髓象中幼红细胞显著增多	骨髓增多,红细胞增多
骨龄提前	骨龄提前
骨龄落后于实际年龄2岁以上	年龄落后,骨龄落后
骨龄超出年龄	骨龄超出,骨龄超出年龄,年龄超出
骶尾部剧烈持续性疼痛	骶尾部疼痛,骶尾部痛
骶尾部包块	骶尾部包块
骶尾部持续性疼痛	骶尾部疼痛,骶尾部痛
骶棘肌痉挛	骶棘肌痉挛,痉挛
骶棘肌痉挛征	骶棘肌痉挛征
骶髂关节压痛	关节压痛,骶髂关节压痛,关节痛,骶髂疼痛
骶髂区疼痛	骶髂疼痛
骶髂旁压痛	骶髂疼痛
骶髂部不适	骶髂部不适
骶髂部发僵	骶髂部发僵
骶髂部疼痛	骶髂部疼痛,骶髂疼痛
髋关节内旋受限	髋关节内旋受限
髋关节双侧交替性疼痛	髋痛,髋关节疼痛,关节痛,髋关节痛
髋关节外展受限	髋关节外展受限
髋关节外展活动受限	髋关节活动受限,髋关节外展
髋关节屈曲	髋关节屈曲
髋关节屈曲不能伸直	髋关节不能伸直,髋关节屈曲
髋关节屈曲外展试验阳性	髋关节屈曲外展试验阳性
髋关节手杖畸形	髋关节畸形
髋关节活动受限	髋关节活动受限
髋关节疼痛	关节痛,关节疼痛,髋痛,髋关节疼痛
髋关节痛	髋关节痛,髋关节疼痛,关节痛,髋痛
髋关节酸痛	关节痛,髋痛,髋关节酸痛
髋膝踝关节三联屈曲	踝关节屈曲,髋膝屈曲
髋部疼痛	髋痛,髋部疼痛
髌阵挛	髌阵挛
髌骨下疼痛	髌骨疼痛
髌骨后疼痛	髌骨疼痛
髌骨边缘压痛	髌骨压痛
髓关节活动少且受限	髓关节活动受限
髓腔增宽	髓腔增宽
高位截瘫	截瘫
高出粘膜的深红色肿块	粘膜肿块,粘膜深红色
高密度脂蛋白胆固醇增高	高密度脂蛋白胆固醇增高,高密度脂蛋白胆固醇升高
高密度脂蛋白胆固醇降低	高密度脂蛋白减低,高密度脂蛋白胆固醇降低
高尿酸血症	高尿酸血症
高度水肿	水肿
高热	高热,发热
高热性谵妄	谵妄
高热惊厥	高热惊厥
高甘油三酸酯血症	高甘油三酸酯血症
高碳酸血症	高碳酸血症
高粘血症	血症
高胆红素血症	高胆红素血症,总胆红素增高
高胰岛素血症	高胰岛素血症
高脂血症	高脂血症
高血压	高血压
高血压发作时心悸	心悸,高血压
高血压眼底病变	高血压
高血糖	高血糖
高血钾	高血钾,血钾高
高钙血症	高钙血症
高钾血症	高钾血症
高颅压症状	高颅压症状
鱼样嘴	鱼样嘴
鱼际肌萎缩	鱼际肌萎缩
鱼鳞病	鱼鳞病
鲨革样斑	鲨革样斑
鸡眼	鸡眼
鸡胸	鸡胸
鸭步	鸭步
鹅口疮	鹅口疮
鹅颈	鹅颈
鹤腿	鹤腿
麦氏点压痛	麦氏点压痛
麦氏点固定压痛	麦氏点固定压痛
麻疹样皮疹	皮疹
麻疹病毒血清IgM抗体阳性	血清阳性
麻痹性肠梗阻	麻痹性肠梗阻
黄斑水肿	水肿
黄水样便	水样便,稀便
黄疸	黄疸
黄疸持续时间2周以上	黄疸
黄疸深重	黄疸,黄疸深重
黄疸进行性加深	黄疸
黄疸退而复现	黄疸
黄绿色水样便	稀便,水样便
黄绿色稀便	稀便
黄绿色胸水	胸水
黄色水样便	稀便,水样便
黄色稀便	稀便
黏液便	便黏液
黏液性水肿	水肿
黏液样便	便黏液样
黏液样血便	血便
黏液脓血便	脓血便
黏液血便	血便
黏痰	黏痰,咳痰
黏稠痰液	痰液黏稠
黏膜出血	黏膜出血
黏膜红紫	黏膜红紫
黏膜色素沉着	黏膜色素沉着
黑便	黑便
黑曚	黑曚
黑棘皮病	黑棘皮病
黑棘皮症	黑棘皮病,黑棘皮症
黑矇	黑曚,黑矇
黑色素瘤相关抗原（HMB45）阳性	肌红蛋白阳性,黑色素瘤
黑色胸水	胸水
黑色黏稠鼻涕	鼻涕黑色,鼻涕黏稠
黑蒙	黑曚,黑蒙
鼓室内灰白色鳞屑状物	鼓室内鳞屑状物,鼓室内灰白色
鼓室内豆渣样物	鼓室内豆渣样物
鼓室息肉	鼓室息肉
鼓室黏膜充血	鼓室黏膜充血,黏膜充血,鼓室充血
鼓室黏膜增厚	黏膜增厚,鼓室黏膜增厚,鼓室增厚
鼓气漏气	鼓气漏气
鼓腮困难	鼓腮困难
鼓膜下血肿	血肿
鼓膜乳白色	鼓膜乳白色
鼓膜充血	鼓膜充血
鼓膜内陷	鼓膜内陷
鼓膜后上方淡黄色大疱	鼓膜淡黄色,鼓膜大疱
鼓膜后上方紫色大疱	鼓膜大疱,鼓膜紫色
鼓膜大疱	鼓膜大疱
鼓膜失去正常光泽	鼓膜失去正常光泽
鼓膜局部小黄点	鼓膜黄点,鼓膜小
鼓膜弥漫性充血	鼓膜充血
鼓膜弥漫性肿胀	鼓膜肿胀
鼓膜松弛部充血	鼓膜松弛部充血
鼓膜松弛部穿孔	鼓膜松弛部穿孔
鼓膜橙红油亮	鼓膜橙红油亮
鼓膜活动受限	鼓膜活动受限
鼓膜淡黄色	鼓膜淡黄色
鼓膜灰蓝色	鼓膜灰蓝色
鼓膜琥珀色	鼓膜琥珀色
鼓膜疱疹	疱疹,鼓膜疱疹
鼓膜穿孔	鼓膜穿孔
鼓膜紧张部中央性穿孔	鼓膜紧张部穿孔
鼓膜紧张部周围血管放射状扩张	血管扩张,鼓膜紧张部扩张
鼓膜紧张部微血管扩张	鼓膜紧张部扩张,微血管扩张,鼓膜紧张部微血管扩张
鼓膜紧张部穿孔	鼓膜紧张部穿孔
鼓膜膨出	鼓膜膨出
鼓膜血性渗出液	鼓膜渗出液
鼓膜轻度水肿	水肿,鼓膜肿胀
鼓膜边缘性穿孔	鼓膜穿孔
鼓膜邻近皮肤充血	鼓膜充血,鼓膜邻近,皮肤充血,皮肤邻近
鼻下气肿	气肿,鼻下气肿
鼻中隔对称性膨隆	鼻中隔隆
鼻中隔溃疡	鼻中隔溃疡
鼻中隔穿孔	鼻中隔穿孔
鼻中隔穿孔处结痂	鼻中隔穿孔处结痂
鼻中隔肉芽肿性增生	鼻中隔增生
鼻中隔肉芽肿性溃疡	鼻中隔溃疡
鼻中隔触痛明显	鼻中隔触痛,鼻中隔明显
鼻中隔隆起对血管收缩剂无反应	鼻中隔隆,血管收缩,鼻中隔收缩,血管无反应,血管隆起,鼻中隔无反应
鼻内干燥	鼻内干燥
鼻内干燥结痂	鼻内结痂,鼻内干燥
鼻内灼烧感	鼻内灼烧感
鼻内结痂带血	鼻内结痂,鼻内带血
鼻出血	鼻出血,出血倾向
鼻分泌物不易擤出	分泌物不易,鼻不易
鼻前庭异物感	异物感,鼻前庭异物感
鼻前庭有假膜	假膜
鼻前庭皮肤发痒	皮肤发痒,鼻前庭皮肤发痒
鼻前庭皮肤干燥	鼻前庭皮肤干燥,皮肤弹性差,皮肤干枯,皮肤干燥
鼻前庭隆起	鼻前庭隆起
鼻后滴涕	鼻后滴涕,滴涕
鼻后滴漏感	鼻后滴漏感
鼻呼吸困难	气促,鼻呼吸困难,呼吸困难
鼻咽部干燥感	鼻咽部干燥感
鼻咽部溃疡	鼻咽部溃疡
鼻咽部隆起	鼻咽部隆起
鼻咽部隐痛	鼻咽部隐痛
鼻咽顶后壁小结节状隆起	顶后壁隆起,鼻咽隆起,顶后壁小结节,鼻咽小结节
鼻咽顶后壁肉芽肿性隆起	顶后壁隆起,鼻咽隆起
鼻咽顶后壁黏膜下隆起	黏膜隆起,顶后壁隆起,鼻咽隆起
鼻唇沟变浅	鼻唇沟变浅
鼻唇沟隆起	鼻唇沟隆起
鼻塞	鼻塞
鼻孔上翻	鼻孔上翻
鼻孔内疼痛	鼻孔内疼痛
鼻孔内皮肤溃烂	鼻孔内溃烂,鼻孔内皮肤溃烂,皮肤溃疡
鼻孔内皮肤红肿	鼻孔内红肿,皮肤红肿,皮肤肿胀,鼻孔内皮肤红肿
鼻孔周皮肤受累发红糜烂结痂	鼻孔发红,皮肤结痂,鼻孔结痂,鼻孔糜烂,皮肤糜烂,皮肤红,皮肤受累,鼻孔受累,皮肤发红
鼻尖变小	鼻尖变小
鼻息肉史	鼻息肉
鼻根部头痛	鼻根部头痛,头痛
鼻根部扁平宽大	鼻根部扁平,鼻根部宽大
鼻梁低下	鼻梁低下
鼻梁凹陷	鼻梁凹陷
鼻梁压迫感	鼻梁压迫感
鼻梁塌陷	鼻梁塌凹,鼻梁凹陷,鼻梁塌陷
鼻梁宽平	鼻梁宽平
鼻梁蝶形红斑	鼻梁红斑
鼻毛稀少	鼻毛稀少
鼻涕带血	鼻涕带血
鼻漏	鼻漏
鼻甲缩小	鼻甲缩小
鼻畸形	鼻畸形
鼻疖	鼻疖
鼻痒	鼻痒
鼻移位	鼻移位
鼻窦压痛	鼻窦叩痛,鼻窦压痛
鼻窦叩痛	鼻窦叩痛
鼻窦圆形阴影	鼻窦圆形阴影
鼻窦炎	鼻窦炎
鼻窦部疼痛	鼻窦部疼痛,鼻窦叩痛
鼻粘膜溃疡	鼻粘膜溃疡
鼻翼扇动	鼻翼煽动,鼻扇,鼻翼扇动
鼻翼煽动	呼吸困难,鼻翼煽动
鼻翼萎缩变软	鼻翼变软,鼻翼萎缩
鼻翼隆起	鼻翼隆起
鼻背变宽	鼻背变宽
鼻背胀痛	鼻背胀痛
鼻腔内膨隆	鼻腔内膨隆
鼻腔出血	鼻腔出血
鼻腔分叶状肿物	鼻腔肿物
鼻腔圆形肿物	鼻腔肿物
鼻腔外侧壁向内膨隆	鼻腔膨隆
鼻腔大量结痂	鼻腔大量,鼻腔结痂
鼻腔宽大	鼻腔宽大
鼻腔干燥	鼻腔干燥
鼻腔异物感	异物感,鼻腔异物感
鼻腔息肉样肿物	鼻腔息肉,鼻腔肿物
鼻腔息肉状肿物	鼻腔肿物
鼻腔新生物	鼻腔新生物
鼻腔暗红肿瘤	鼻腔暗红,鼻腔肿瘤
鼻腔水样分泌物	鼻腔水样分泌物
鼻腔灰白色肿物	鼻腔肿物
鼻腔粘膜充血	鼻腔充血,粘膜充血,鼻腔粘膜充血
鼻腔粘膜水肿	鼻腔水肿,粘膜水肿
鼻腔粘膜肿胀	鼻腔肿胀,粘膜肿胀,鼻腔粘膜肿胀
鼻腔结节状肿物	鼻腔肿物,鼻腔结节状
鼻腔肿物	鼻腔肿物
鼻腔肿物有弹性	鼻腔肿物
鼻腔鲜红肿瘤	鼻腔肿瘤,鼻腔鲜红
鼻腔黏膜充血	黏膜充血,鼻腔充血,鼻腔黏膜充血
鼻腔黏膜干燥	鼻腔干燥,鼻腔黏膜干燥,黏膜干燥
鼻腔黏膜水肿	黏膜水肿,鼻腔水肿
鼻腔黏膜灼热感	鼻腔黏膜灼热感,鼻腔灼热感,黏膜灼热感
鼻腔黏膜痒感	黏膜痒感,鼻腔痒感,鼻腔黏膜痒感
鼻腔黏膜肥厚	鼻腔肥厚,黏膜肥厚,鼻腔黏膜肥厚
鼻腔黏膜肿胀	鼻腔黏膜肿胀,黏膜肿胀,鼻腔肿胀
鼻部剧烈疼痛	鼻背胀痛,鼻部疼痛
鼻部畸形	鼻畸形,鼻部畸形
鼻部疼痛	鼻背胀痛,鼻部疼痛
鼻部红肿	鼻部红肿,鼻部肿胀
鼻部肿胀	鼻部肿胀
鼻部胀满感	鼻部胀满感
鼻部触痛	鼻背胀痛,鼻部触痛
鼻部隆起	鼻部隆起
鼻部麻木感	鼻部麻木感
鼻面部畸形	鼻畸形,面部畸形,鼻面部畸形
鼻顶下陷	鼻顶下陷
鼻额角变锐	鼻额角变锐
鼻黏膜溃疡	鼻黏膜溃疡
鼻黏膜痛性溃疡	鼻黏膜痛性溃疡
鼻黏膜糜烂	鼻黏膜糜烂
鼻黏膜苍白	鼻黏膜苍白
鼾声	鼾声
齿轮样肌肉强直	肌肉强直
齿间隙增宽	齿间隙增宽
齿龈出血	齿龈出血,出血
齿龈疱疹	疱疹,齿龈疱疹
齿龈红肿	齿龈红肿
龋齿	龋齿
